dcode,dname,sdname,name_of_community,type_of_community,community_population_count,male_count,female_count
1033,คลองเตย,คลองเตย,คลองเตยล็อค 1 - 3,ชุมชนแออัด,7366,3297,4069
1033,คลองเตย,คลองเตย,คลองเตยล็อค 4 - 6,ชุมชนแออัด,2019,920,1099
1033,คลองเตย,คลองเตย,ตลาดท่าเรือคลองเตย,ชุมชนเมือง,4995,1999,2996
1033,คลองเตย,คลองเตย,แฟลต 1-10,ชุมชนอาคารสูง,6840,2840,4000
1033,คลองเตย,คลองเตย,แฟลต 11-18,ชุมชนอาคารสูง,8450,5700,2750
1033,คลองเตย,คลองเตย,แฟลต 19-22,ชุมชนอาคารสูง,1945,875,1070
1033,คลองเตย,คลองเตย,หมู่บ้านพัฒนา 70 ไร่,ชุมชนแออัด,9685,4642,5043
1033,คลองเตย,คลองเตย,ร่มเกล้า,ชุมชนแออัด,1075,504,571
1033,คลองเตย,คลองเตย,ซอยเจริญสุข,ชุมชนเมือง,6500,3257,3243
1033,คลองเตย,คลองเตย,น้องใหม่,ชุมชนแออัด,356,200,156
1033,คลองเตย,คลองเตย,พัฒนาใหม่,ชุมชนแออัด,1523,748,775
1033,คลองเตย,คลองเตย,พัฒนาอาเซีย,ชุมชนแออัด,195,89,106
1033,คลองเตย,คลองเตย,ริมคลองวัดสะพาน,ชุมชนแออัด,1113,536,577
1033,คลองเตย,คลองเตย,ริมคลองสามัคคี,ชุมชนแออัด,650,350,300
1033,คลองเตย,คลองเตย,ริมทางรถไฟสายท่าเรือ,ชุมชนแออัด,3495,1980,1515
1033,คลองเตย,คลองเตย,โรงหมู,ชุมชนแออัด,2238,995,1243
1033,คลองเตย,คลองเตย,วัดคลองเตยใน 1,ชุมชนแออัด,572,222,350
1033,คลองเตย,คลองเตย,วัดคลองเตยใน 2,ชุมชนแออัด,1899,802,1097
1033,คลองเตย,คลองเตย,หัวโค้ง,ชุมชนแออัด,2780,1180,1600
1033,คลองเตย,คลองเตย,แฟลต 23-24,ชุมชนอาคารสูง,1165,533,632
1033,คลองเตย,คลองเตย,ตลาดปีนัง,ชุมชนแออัด,515,250,265
1033,คลองเตย,คลองเตย,วัดคลองเตยใน 3,ชุมชนแออัด,933,401,532
1033,คลองเตย,คลองเตย,ร่วมใจสามัคคี,ชุมชนแออัด,550,200,350
1033,คลองเตย,คลองเตย,ริมคลองไผ่สิงโต,ชุมชนแออัด,312,109,203
1033,คลองเตย,คลองเตย,ตลาดปีนังพัฒนา,ชุมชนเมือง,766,267,499
1033,คลองเตย,คลองเตย,อาคารทรัพย์สิน 26-7,ชุมชนอาคารสูง,1256,556,700
1033,คลองเตย,คลองเตย,เทพประทาน,ชุมชนอาคารสูง,4400,1774,2626
1033,คลองเตย,คลองเตย,สร้างสรรค์พัฒนา 7-12 (บ้านมั่นคง),ชุมชนเมือง,0,0,0
1033,คลองเตย,คลองตัน,นภาศัพท์แยก 4,ชุมชนเมือง,697,314,383
1033,คลองเตย,คลองตัน,ทรัพย์มโนทัย,ชุมชนเมือง,1950,1265,685
1033,คลองเตย,คลองตัน,แสนสบาย-แสนสุข,ชุมชนเมือง,3160,1500,1660
1033,คลองเตย,พระโขนง,เกาะกลาง,ชุมชนเมือง,230,130,100
1033,คลองเตย,พระโขนง,ข้างโรงเรียนวัดสะพาน,ชุมชนแออัด,193,76,117
1033,คลองเตย,พระโขนง,บ้านกล้วย,ชุมชนแออัด,781,399,382
1033,คลองเตย,พระโขนง,ปิยะวัชร,ชุมชนเมือง,524,249,275
1033,คลองเตย,พระโขนง,ภูมิจิตร,ชุมชนเมือง,570,270,300
1033,คลองเตย,พระโขนง,ริมคลองพระโขนง (โรงฟอกหนัง),ชุมชนแออัด,1118,498,620
1033,คลองเตย,พระโขนง,สวนอ้อย,ชุมชนแออัด,1233,510,723
1033,คลองเตย,พระโขนง,หมู่บ้านเปรมฤทัย,ชุมชนเมือง,414,210,204
1033,คลองเตย,พระโขนง,สวนไทร,ชุมชนเมือง,317,148,169
1018,คลองสาน,สมเด็จเจ้าพระยา,ซอยช่างนาค-สะพานยาว,ชุมชนแออัด,2277,1103,1174
1018,คลองสาน,สมเด็จเจ้าพระยา,สวนสมเด็จย่า,ชุมชนเมือง,6750,2850,3900
1018,คลองสาน,คลองสาน,วัดทองธรรมชาติ,ชุมชนแออัด,749,375,374
1018,คลองสาน,คลองสาน,วัดทองนพคุณ,ชุมชนแออัด,1213,579,634
1018,คลองสาน,คลองสาน,หลังโรงพยาบาลสมเด็จเจ้าพระยา,ชุมชนแออัด,118,62,56
1018,คลองสาน,คลองสาน,หลังโรงเรียนกุลสิริเทคโนโลยี,ชุมชนแออัด,109,57,52
1018,คลองสาน,คลองสาน,หลังโรงเรียนสารพัดช่างธนบุรี,ชุมชนแออัด,552,263,289
1018,คลองสาน,คลองสาน,ซอยแยกถนนเชียงใหม่,ชุมชนแออัด,344,171,173
1018,คลองสาน,คลองสาน,ซอยเจริญรัถ 5,ชุมชนแออัด,190,97,93
1018,คลองสาน,คลองสาน,ชาวประชาท่าดินแดง,ชุมชนเมือง,395,181,214
1018,คลองสาน,คลองสาน,ซอยท่าดินแดง14 และซอยท่าดินแดง 16,ชุมชนเมือง,2147,981,1166
1018,คลองสาน,บางลำภูล่าง,อู่ใหม่,ชุมชนแออัด,364,167,197
1018,คลองสาน,บางลำภูล่าง,คลองต้นไทร,ชุมชนแออัด,944,427,517
1018,คลองสาน,บางลำภูล่าง,คลองพระยาเกษม,ชุมชนแออัด,1016,489,527
1018,คลองสาน,บางลำภูล่าง,ซอยเกษมใหม่,ชุมชนแออัด,432,212,220
1018,คลองสาน,บางลำภูล่าง,ซอยวัฒนา,ชุมชนแออัด,1020,440,580
1018,คลองสาน,บางลำภูล่าง,ซอยหงษ์ทอง,ชุมชนแออัด,505,210,295
1018,คลองสาน,บางลำภูล่าง,สำปาย้าพัฒนา,ชุมชนแออัด,1138,613,525
1018,คลองสาน,บางลำภูล่าง,วัดเศวตฉัตร,ชุมชนแออัด,722,351,371
1018,คลองสาน,บางลำภูล่าง,วัดสุทธาราม,ชุมชนแออัด,1411,671,740
1018,คลองสาน,บางลำภูล่าง,หลวงพ่อโบสถ์บน,ชุมชนแออัด,381,153,228
1018,คลองสาน,บางลำภูล่าง,หลังตลาดเจริญนคร,ชุมชนแออัด,1943,926,1017
1018,คลองสาน,คลองต้นไทร,ซอยราษฎร์ร่วมเจริญ,ชุมชนเมือง,190,113,77
1018,คลองสาน,คลองต้นไทร,ซอยวนาวรรณ,ชุมชนแออัด,2517,1215,1302
1018,คลองสาน,คลองต้นไทร,ซอยวัดสุวรรณ,ชุมชนแออัด,214,84,130
1018,คลองสาน,คลองต้นไทร,มัสยิดสุวรรณภูมิ,ชุมชนแออัด,439,182,257
1018,คลองสาน,คลองต้นไทร,วัดทองเพลง,ชุมชนแออัด,571,277,294
1018,คลองสาน,คลองต้นไทร,หน้าตลาดศิรินทร์,ชุมชนแออัด,304,102,202
1018,คลองสาน,คลองต้นไทร,ตรอกงูเห่า,ชุมชนแออัด,190,113,77
1018,คลองสาน,คลองต้นไทร,สองร้อยห้อง,ชุมชนแออัด,1053,423,630
1018,คลองสาน,คลองต้นไทร,ศาลเจ้าอาเหนียว,ชุมชนแออัด,1291,567,724
1018,คลองสาน,คลองต้นไทร,หลังโรงภาพยนต์ไทยรามา,ชุมชนเมือง,1284,589,695
1018,คลองสาน,คลองต้นไทร,ซอยเจริญรัถ 12,ชุมชนแออัด,115,55,60
1046,คลองสามวา,สามวาตะวันตก,"แป้นทองสัมพันธ์ หมู่13,14",ชุมชนชานเมือง,570,270,300
1046,คลองสามวา,สามวาตะวันตก,มีนทองพัฒนา หมู่ 2,ชุมชนชานเมือง,417,186,231
1046,คลองสามวา,สามวาตะวันตก,ร่มรื่น หมู่10,ชุมชนชานเมือง,1256,651,605
1046,คลองสามวา,สามวาตะวันตก,ราษฎร์นิมิตสัมพันธ์ หมู่ 1,ชุมชนชานเมือง,620,300,320
1046,คลองสามวา,สามวาตะวันตก,สายสัมพันธ์พัฒนา หมู่ 5,ชุมชนชานเมือง,453,239,214
1046,คลองสามวา,สามวาตะวันตก,สุขสำราญพัฒนา หมู่12,ชุมชนชานเมือง,490,244,246
1046,คลองสามวา,สามวาตะวันตก,เบญจมพัฒนา หมู่ 9,ชุมชนชานเมือง,340,151,189
1046,คลองสามวา,สามวาตะวันตก,เมืองประชา-รามอินทรา,ชุมชนเมือง,8225,3715,4510
1046,คลองสามวา,สามวาตะวันตก,พระยาสุเรนทร์,ชุมชนชานเมือง,609,277,332
1046,คลองสามวา,สามวาตะวันตก,มโนรมย์ 5,ชุมชนเมือง,673,325,348
1046,คลองสามวา,สามวาตะวันตก,หมู่บ้านเค.ซี. 4 ร่วมใจ,ชุมชนเมือง,601,282,319
1046,คลองสามวา,สามวาตะวันตก,ริมคลองหนองระแหง,ชุมชนชานเมือง,345,172,173
1046,คลองสามวา,สามวาตะวันตก,หมู่บ้านเลิศอุบล พระยาสุเรนทร์ 44,ชุมชนเมือง,1485,661,824
1046,คลองสามวา,สามวาตะวันออก,สุขสันต์พัฒนา หมู่1,ชุมชนชานเมือง,769,365,404
1046,คลองสามวา,สามวาตะวันออก,น้ำใสดอกไม้สวย หมู่ 19,ชุมชนชานเมือง,304,162,142
1046,คลองสามวา,สามวาตะวันออก,ประชาสร้างสรรค์ หมู่ 21,ชุมชนชานเมือง,470,231,239
1046,คลองสามวา,สามวาตะวันออก,เฟื่องฟ้าพัฒนา หมู่ 11,ชุมชนชานเมือง,505,236,269
1046,คลองสามวา,สามวาตะวันออก,รวมน้ำใจพัฒนา หมู่ 20,ชุมชนชานเมือง,218,101,117
1046,คลองสามวา,สามวาตะวันออก,พร้อมพัฒนา หมู่ 8,ชุมชนชานเมือง,611,300,311
1046,คลองสามวา,สามวาตะวันออก,สามัคคีพัฒนา หมู่ 13,ชุมชนชานเมือง,453,203,250
1046,คลองสามวา,สามวาตะวันออก,หมู่ 14,ชุมชนชานเมือง,457,221,236
1046,คลองสามวา,สามวาตะวันออก,หมู่ 15,ชุมชนชานเมือง,925,515,410
1046,คลองสามวา,สามวาตะวันออก,พร้อมใจพัฒนา หมู่ 2,ชุมชนชานเมือง,1653,784,869
1046,คลองสามวา,สามวาตะวันออก,หมู่ 12 แขวงสามวาตะวันออก,ชุมชนชานเมือง,155,59,96
1046,คลองสามวา,สามวาตะวันออก,ดารุสสลามสร้างสรรค์ หมู่ 9,ชุมชนชานเมือง,1055,517,538
1046,คลองสามวา,สามวาตะวันออก,วัดสุขใจ,ชุมชนชานเมือง,580,259,321
1046,คลองสามวา,สามวาตะวันออก,ประสานมิตรพัฒนา หมู่ที่ 5,ชุมชนชานเมือง,303,165,138
1046,คลองสามวา,สามวาตะวันออก,คลองลำมะเขือขื่น,ชุมชนชานเมือง,473,237,236
1046,คลองสามวา,สามวาตะวันออก,ทุ่งรวงทองพัฒนาแบนชะโด,ชุมชนชานเมือง,543,265,278
1046,คลองสามวา,สามวาตะวันออก,คลองลำกะดาน,ชุมชนชานเมือง,707,354,353
1046,คลองสามวา,สามวาตะวันออก,หมู่ 3 แขวงสามวาตะวันออก,ชุมชนชานเมือง,675,235,440
1046,คลองสามวา,สามวาตะวันออก,อาสาพัฒนา,ชุมชนชานเมือง,320,158,162
1046,คลองสามวา,สามวาตะวันออก,เคหะคลองเก้า,ชุมชนเมือง,1976,1040,936
1046,คลองสามวา,บางชัน,ไทยเอราวัณ หมู่ 8,ชุมชนเมือง,329,163,166
1046,คลองสามวา,บางชัน,ภู่ระหงษ์ 2 หมู่ 4,ชุมชนเมือง,272,129,143
1046,คลองสามวา,บางชัน,เจริญพัฒนา (คูคต),ชุมชนชานเมือง,250,110,140
1046,คลองสามวา,บางชัน,ร่วมใจพัฒนา (คลองกีบหมู) หมู่ 11,ชุมชนชานเมือง,474,238,236
1046,คลองสามวา,บางชัน,หมู่บ้านธีรวรรณ,ชุมชนเมือง,1886,810,1076
1046,คลองสามวา,บางชัน,นีรชา,ชุมชนเมือง,335,150,185
1046,คลองสามวา,บางชัน,หมู่บ้านเพรชไพลิน,ชุมชนเมือง,364,174,190
1046,คลองสามวา,บางชัน,หมู่บ้านพร้อมสุข 1,ชุมชนเมือง,468,241,227
1046,คลองสามวา,บางชัน,หมู่บ้านร่มทิพย์ โครงการ 2,ชุมชนเมือง,2000,930,1070
1046,คลองสามวา,บางชัน,หมู่บ้านกรีนวิลล์,ชุมชนเมือง,213,99,114
1046,คลองสามวา,บางชัน,หมู่บ้านพูน,ชุมชนเมือง,815,374,441
1046,คลองสามวา,บางชัน,ประยงค์แย้ม,ชุมชนชานเมือง,350,140,210
1046,คลองสามวา,บางชัน,บำรุงสุข-บุญมา,ชุมชนชานเมือง,2200,912,1288
1046,คลองสามวา,บางชัน,หมู่บ้านร่มเย็น 5 พัฒนา,ชุมชนเมือง,1432,651,781
1046,คลองสามวา,บางชัน,บ้านลำกระโหลก,ชุมชนชานเมือง,815,380,435
1046,คลองสามวา,บางชัน,กาญจนา,ชุมชนชานเมือง,352,153,199
1046,คลองสามวา,บางชัน,รุ่งเรือง 1,ชุมชนชานเมือง,1057,552,505
1046,คลองสามวา,บางชัน,เฟื่องฟ้าวิลเลจ,ชุมชนเมือง,499,233,266
1046,คลองสามวา,บางชัน,หมู่บ้านอาลักษณ์,ชุมชนเมือง,445,203,242
1046,คลองสามวา,บางชัน,หมู่บ้านหทัยราษฎร์พัฒนา,ชุมชนเมือง,924,449,475
1046,คลองสามวา,บางชัน,หมู่บ้านแสนนคร,ชุมชนเมือง,416,192,224
1046,คลองสามวา,บางชัน,มหาโชค,ชุมชนเมือง,947,439,508
1046,คลองสามวา,บางชัน,หมู่บ้านร่มเย็น 24,ชุมชนเมือง,541,269,272
1046,คลองสามวา,บางชัน,หทัยราษฎร์ 31,ชุมชนเมือง,315,159,156
1046,คลองสามวา,บางชัน,หมู่บ้านนันทิศา,ชุมชนเมือง,431,205,226
1046,คลองสามวา,บางชัน,หมู่บ้านทหารกองหนุน,ชุมชนเมือง,954,449,505
1046,คลองสามวา,บางชัน,หมู่บ้านเจริญทรัพย์,ชุมชนเมือง,365,169,196
1046,คลองสามวา,ทรายกองดิน,บัวแก้วพัฒนา หมู่ 1,ชุมชนชานเมือง,604,251,353
1046,คลองสามวา,ทรายกองดิน,วังตาหนวดพัฒนา หมู่ 5,ชุมชนชานเมือง,675,235,440
1046,คลองสามวา,ทรายกองดิน,บึงไผ่,ชุมชนชานเมือง,548,238,310
1046,คลองสามวา,ทรายกองดิน,ริมคลอง 1,ชุมชนชานเมือง,955,480,475
1046,คลองสามวา,ทรายกองดิน,ร่วมแรงร่วมใจพัฒนา,ชุมชนชานเมือง,308,156,152
1046,คลองสามวา,ทรายกองดิน,หมู่บ้านอินทราวิว,ชุมชนเมือง,472,233,239
1046,คลองสามวา,ทรายกองดินใต้,กมาลุลอิสลาม หมู่ 5,ชุมชนชานเมือง,777,380,397
1046,คลองสามวา,ทรายกองดินใต้,เกาะขุนเณร หมู่ 12,ชุมชนชานเมือง,1125,520,605
1046,คลองสามวา,ทรายกองดินใต้,อาบูพัฒนา หมู่ 7,ชุมชนชานเมือง,458,224,234
1046,คลองสามวา,ทรายกองดินใต้,มัสยิดฮิดายาตุ้ลอิสลามมิยะห์ (แสนแสบ),ชุมชนชานเมือง,850,690,160
1046,คลองสามวา,ทรายกองดินใต้,ห้าพี่น้องพัฒนา,ชุมชนชานเมือง,488,219,269
1046,คลองสามวา,ทรายกองดินใต้,เจริญสุขพัฒนา,ชุมชนชานเมือง,553,287,266
1046,คลองสามวา,ทรายกองดินใต้,หมู่บ้านอินเตอร์ หมู่ที่ 10,ชุมชนชานเมือง,388,199,189
1046,คลองสามวา,ทรายกองดินใต้,ร่วมใจรักพัฒนา,ชุมชนชานเมือง,686,304,382
1046,คลองสามวา,ทรายกองดินใต้,ร่วมพลังพัฒนา,ชุมชนชานเมือง,373,190,183
1046,คลองสามวา,ทรายกองดินใต้,สามัคคีทำ,ชุมชนชานเมือง,713,359,354
1046,คลองสามวา,ทรายกองดินใต้,หมู่ 8 ร่วมใจพัฒนา,ชุมชนชานเมือง,350,160,190
1046,คลองสามวา,ทรายกองดินใต้,นูรุดดีน,ชุมชนชานเมือง,506,248,258
1046,คลองสามวา,ทรายกองดินใต้,วาสิฎฐี,ชุมชนชานเมือง,383,180,203
1046,คลองสามวา,ทรายกองดินใต้,ตาหวานพัฒนา,ชุมชนชานเมือง,500,257,243
1046,คลองสามวา,ทรายกองดินใต้,ศรีบูรพาบ้านแบนชะโด,ชุมชนชานเมือง,1576,987,589
1046,คลองสามวา,ทรายกองดินใต้,สุขใจสามัคคี,ชุมชนชานเมือง,620,292,328
1046,คลองสามวา,ทรายกองดินใต้,ประชาร่วมใจพัฒนา,ชุมชนเมือง,470,229,241
1046,คลองสามวา,ทรายกองดินใต้,หมู่บ้านสุขประชา,ชุมชนเมือง,1000,400,600
1043,คันนายาว,คันนายาว,เกาะจวน,ชุมชนแออัด,1232,597,635
1043,คันนายาว,คันนายาว,บ้านเกาะ,ชุมชนแออัด,2096,1071,1025
1043,คันนายาว,คันนายาว,ริมคลองลำเกร็ด,ชุมชนชานเมือง,667,317,350
1043,คันนายาว,คันนายาว,ริมคลองหลอแหล,ชุมชนแออัด,532,266,266
1043,คันนายาว,คันนายาว,วิมานสุข,ชุมชนแออัด,1817,853,964
1043,คันนายาว,คันนายาว,"หมู่ 6,8 คันนายาว",ชุมชนชานเมือง,562,270,292
1043,คันนายาว,คันนายาว,สยามพัฒนา,ชุมชนแออัด,459,201,258
1043,คันนายาว,คันนายาว,หมู่บ้านอมรพันธ์นครสวนสยาม,ชุมชนเมือง,1451,666,785
1043,คันนายาว,คันนายาว,นภาพิไลพัฒนา,ชุมชนแออัด,841,318,523
1043,คันนายาว,คันนายาว,สุเหร่าแดง,ชุมชนแออัด,1013,499,514
1043,คันนายาว,คันนายาว,หมู่บ้านรังสิยา,ชุมชนเมือง,581,260,321
1043,คันนายาว,คันนายาว,หมู่บ้านอมรพันธ์นครเสรีไทย,ชุมชนเมือง,304,133,171
1043,คันนายาว,คันนายาว,หมู่ 5,ชุมชนเมือง,511,255,256
1043,คันนายาว,คันนายาว,สุขอนันต์,ชุมชนเมือง,1211,585,626
1043,คันนายาว,คันนายาว,หมู่บ้านเปรมฤทัยรามอินทรา ก.ม.9 ป.1,ชุมชนเมือง,1420,688,732
1043,คันนายาว,คันนายาว,สน.บางชัน,ชุมชนอาคารสูง,416,254,162
1043,คันนายาว,คันนายาว,อมรพันธ์ 135,ชุมชนเมือง,690,327,363
1043,คันนายาว,คันนายาว,หมู่บ้านแสงอรุณ,ชุมชนเมือง,1536,720,816
1043,คันนายาว,คันนายาว,คลองลำนุ่น,ชุมชนแออัด,172,86,86
1043,คันนายาว,คันนายาว,หมู่ 3 รวมใจพัฒนา,ชุมชนแออัด,696,314,382
1043,คันนายาว,คันนายาว,หมู่บ้านอมรวิวัฒน์,ชุมชนเมือง,554,275,279
1043,คันนายาว,รามอินทรา,ซอยประสิทธิชัย,ชุมชนเมือง,424,195,229
1043,คันนายาว,รามอินทรา,ซอยผู้ใหญ่ชม,ชุมชนแออัด,1081,495,586
1043,คันนายาว,รามอินทรา,หมู่บ้านเปรมฤทัย 1,ชุมชนเมือง,946,439,507
1043,คันนายาว,รามอินทรา,ริมคลองระหัสพัฒนา,ชุมชนแออัด,1389,650,739
1043,คันนายาว,รามอินทรา,เกาะแครายพัฒนา,ชุมชนชานเมือง,293,146,147
1043,คันนายาว,รามอินทรา,หมู่บ้านชื่นกมลนิเวศน์ 4,ชุมชนเมือง,397,184,213
1043,คันนายาว,รามอินทรา,หลวงวิจิตร,ชุมชนแออัด,139,69,70
1043,คันนายาว,รามอินทรา,หมู่บ้านเฉลิมสุขนิเวศน์ 11,ชุมชนเมือง,590,285,305
1043,คันนายาว,รามอินทรา,หมู่บ้านฟายน์โฮมส์ 3,ชุมชนเมือง,846,380,466
1043,คันนายาว,รามอินทรา,หมู่บ้านอัมรินทร์นิเวศน์ 2,ชุมชนเมือง,839,407,432
1043,คันนายาว,รามอินทรา,หมู่บ้านปัฐวิกรณ์ 1 ผัง ก,ชุมชนเมือง,1400,600,800
1043,คันนายาว,รามอินทรา,หมู่บ้านบก.ทหารสูงสุด,ชุมชนเมือง,1277,585,692
1043,คันนายาว,รามอินทรา,หมู่บ้านวาเลนไทน์,ชุมชนเมือง,576,248,328
1043,คันนายาว,รามอินทรา,จินดาบำรุงพัฒนา,ชุมชนแออัด,486,238,248
1043,คันนายาว,รามอินทรา,ซอยรอดอนันต์ 7,ชุมชนเมือง,467,224,243
1043,คันนายาว,รามอินทรา,หมู่บ้านเปรมฤทัย 1/2,ชุมชนเมือง,1066,492,574
1043,คันนายาว,รามอินทรา,สน.คันนายาว,ชุมชนอาคารสูง,257,129,128
1043,คันนายาว,รามอินทรา,"ซอยรามอินทรา 83,85",ชุมชนแออัด,1101,455,646
1043,คันนายาว,รามอินทรา,รามอินทรา 89-91,ชุมชนเมือง,373,182,191
1043,คันนายาว,รามอินทรา,หมู่บ้านชื่นกมลนิเวศน์ 5,ชุมชนเมือง,378,165,213
1030,จตุจักร,ลาดยาว,ประดิษฐ์โทรการ,ชุมชนเมือง,1397,602,795
1030,จตุจักร,ลาดยาว,รัชดาประชาชื่น,ชุมชนเมือง,154,88,66
1030,จตุจักร,ลาดยาว,ประชาร่วมใจ 1,ชุมชนแออัด,1220,643,577
1030,จตุจักร,ลาดยาว,ประชาร่วมใจ 2,ชุมชนแออัด,702,320,382
1030,จตุจักร,ลาดยาว,สามัคคีเทวสุนทร,ชุมชนแออัด,259,122,137
1030,จตุจักร,ลาดยาว,โรงช้อน 45,ชุมชนเมือง,375,123,252
1030,จตุจักร,ลาดยาว,แฟลตตำรวจส่วนกลางลาดยาว,ชุมชนอาคารสูง,1095,560,535
1030,จตุจักร,ลาดยาว,แฟลตตำรวจส่วนกลางวิภาวดีรังสิต,ชุมชนอาคารสูง,1395,710,685
1030,จตุจักร,เสนานิคม,วังหิน,ชุมชนแออัด,375,183,192
1030,จตุจักร,เสนานิคม,วัดบางบัว,ชุมชนแออัด,495,240,255
1030,จตุจักร,เสนานิคม,พหลโยธิน 46,ชุมชนแออัด,258,131,127
1030,จตุจักร,เสนานิคม,หลังกรมวิทยาศาสตร์,ชุมชนแออัด,513,205,308
1030,จตุจักร,เสนานิคม,หมู่บ้านอยู่เจริญพหลโยธิน 40,ชุมชนเมือง,725,310,415
1030,จตุจักร,เสนานิคม,เสนานิคม 2,ชุมชนเมือง,4927,2157,2770
1030,จตุจักร,เสนานิคม,ชายคลองเสนานิคม 2,ชุมชนแออัด,488,248,240
1030,จตุจักร,เสนานิคม,ทหารส่วนแยก บชร.1,ชุมชนอาคารสูง,616,388,228
1030,จตุจักร,เสนานิคม,กรมวิทยาศาสตร์ทหารบก,ชุมชนอาคารสูง,1224,632,592
1030,จตุจักร,เสนานิคม,กรมยุทธโยธาทหารบก,ชุมชนอาคารสูง,1052,482,570
1030,จตุจักร,เสนานิคม,"พลหโยธิน 40,42",ชุมชนเมือง,864,418,446
1030,จตุจักร,จันทรเกษม,หมู่บ้านภาวนา,ชุมชนเมือง,300,148,152
1030,จตุจักร,จันทรเกษม,หลังโรงเจ,ชุมชนแออัด,459,219,240
1030,จตุจักร,จันทรเกษม,หลัง วค.จันทรเกษม,ชุมชนแออัด,560,233,327
1030,จตุจักร,จันทรเกษม,หลังตลาดสุภาพงษ์,ชุมชนแออัด,357,165,192
1030,จตุจักร,จันทรเกษม,นครหลวง,ชุมชนเมือง,918,411,507
1030,จตุจักร,จันทรเกษม,ริมคลองลาดพร้าวภาวนา,ชุมชนแออัด,239,110,129
1030,จตุจักร,จันทรเกษม,หมู่บ้านรุ่งเจริญ,ชุมชนเมือง,1140,680,460
1030,จตุจักร,จันทรเกษม,คลองน้ำแก้ว,ชุมชนแออัด,127,52,75
1030,จตุจักร,จันทรเกษม,พหลโยธิน 32,ชุมชนแออัด,410,205,205
1030,จตุจักร,จอมพล,อยู่เจริญพัฒนา,ชุมชนเมือง,612,233,379
1030,จตุจักร,จอมพล,โชคชัยร่วมมิตร,ชุมชนแออัด,282,132,150
1030,จตุจักร,จอมพล,คลองพระยาเวิก,ชุมชนแออัด,197,88,109
1030,จตุจักร,จอมพล,พหลโยธิน 24,ชุมชนเมือง,932,427,505
1030,จตุจักร,จตุจักร,สวนผัก,ชุมชนเมือง,1202,502,700
1030,จตุจักร,จตุจักร,หนองจุฬา,ชุมชนแออัด,520,250,270
1030,จตุจักร,จตุจักร,พรรณี 1,ชุมชนแออัด,180,70,110
1030,จตุจักร,จตุจักร,เคหะสถานเจริญชัย,ชุมชนชานเมือง,256,113,143
1030,จตุจักร,จตุจักร,ร่วมสุขพัฒนา,ชุมชนแออัด,206,101,105
1030,จตุจักร,จตุจักร,หมู่บ้านไพฑูรย์นิเวศน์,ชุมชนเมือง,435,153,282
1030,จตุจักร,จตุจักร,ซอยภักดี,ชุมชนแออัด,309,139,170
1030,จตุจักร,จตุจักร,ไทรคู่,ชุมชนแออัด,265,110,155
1030,จตุจักร,จตุจักร,ชุมชนบ่อฝรั่งริมน้ำ,ชุมชนอาคารสูง,1035,406,629
1035,จอมทอง,บางขุนเทียน,ซอยบุญอยู่,ชุมชนเมือง,586,213,373
1035,จอมทอง,บางขุนเทียน,ซอยวาสนา,ชุมชนเมือง,485,236,249
1035,จอมทอง,บางขุนเทียน,บางระแนะใหญ่,ชุมชนเมือง,747,319,428
1035,จอมทอง,บางขุนเทียน,วิสุทธิจิตร,ชุมชนเมือง,320,152,168
1035,จอมทอง,บางขุนเทียน,หมู่บ้านพัฒนา หมู่ 11,ชุมชนชานเมือง,685,275,410
1035,จอมทอง,บางขุนเทียน,วัดสิงห์,ชุมชนเมือง,161,81,80
1035,จอมทอง,บางขุนเทียน,คุ้งข้าวหลาม,ชุมชนเมือง,175,84,91
1035,จอมทอง,บางขุนเทียน,ซอยร่วมสุข,ชุมชนเมือง,2006,994,1012
1035,จอมทอง,บางขุนเทียน,โรงพักเก่าบางขุนเทียน,ชุมชนเมือง,345,155,190
1035,จอมทอง,บางขุนเทียน,แก้วกลม,ชุมชนเมือง,573,276,297
1035,จอมทอง,บางขุนเทียน,รวมมิตร (ลุงเป้ง),ชุมชนเมือง,363,172,191
1035,จอมทอง,บางขุนเทียน,ร่วมพัฒนาเอกชัย 31,ชุมชนเมือง,620,297,323
1035,จอมทอง,บางขุนเทียน,สุขสันต์พัฒนาเอกชัย 26,ชุมชนเมือง,264,126,138
1035,จอมทอง,บางขุนเทียน,ตลาดน้ำวัดไทร,ชุมชนเมือง,2130,970,1160
1035,จอมทอง,บางขุนเทียน,หลังตลาดวัดไทร,ชุมชนเมือง,761,312,449
1035,จอมทอง,บางค้อ,ซอยสวนหลวง,ชุมชนเมือง,964,420,544
1035,จอมทอง,บางค้อ,นางนอง 2 สันติสุข,ชุมชนเมือง,2160,1122,1038
1035,จอมทอง,บางค้อ,ริมคลองบางค้อ,ชุมชนเมือง,950,380,570
1035,จอมทอง,บางค้อ,วัดมงคลวราราม,ชุมชนเมือง,1812,799,1013
1035,จอมทอง,บางค้อ,ศิลปเดช,ชุมชนแออัด,2839,1243,1596
1035,จอมทอง,บางค้อ,จันกลิ่นพัฒนา,ชุมชนเมือง,640,273,367
1035,จอมทอง,บางค้อ,สุขศิริ,ชุมชนแออัด,236,102,134
1035,จอมทอง,บางค้อ,วัดนางนอง,ชุมชนเมือง,1500,700,800
1035,จอมทอง,บางค้อ,ซอยชัยวัฒน์ 10,ชุมชนเมือง,358,145,213
1035,จอมทอง,บางค้อ,วุฒากาศ 46 (อพยพ 2),ชุมชนเมือง,481,252,229
1035,จอมทอง,บางค้อ,ศาลาครืนรวมใจ,ชุมชนชานเมือง,1075,452,623
1035,จอมทอง,บางมด,วัดโพธิ์แก้ว,ชุมชนเมือง,4965,2130,2835
1035,จอมทอง,บางมด,วัดสีสุก,ชุมชนเมือง,187,84,103
1035,จอมทอง,บางมด,ป้าแดงพัฒนา 1,ชุมชนแออัด,410,200,210
1035,จอมทอง,บางมด,บางมดพัฒนา หมู่ 7,ชุมชนเมือง,115,56,59
1035,จอมทอง,บางมด,บ้านบางมด,ชุมชนเมือง,601,289,312
1035,จอมทอง,บางมด,สินทวีวิลล่า,ชุมชนเมือง,1863,850,1013
1035,จอมทอง,บางมด,ข้าราชการตำรวจ บก.น.9,ชุมชนอาคารสูง,1860,1045,815
1035,จอมทอง,จอมทอง,ชาวสวนสัมพันธ์,ชุมชนชานเมือง,647,328,319
1035,จอมทอง,จอมทอง,ซอยเทียนทรัพย์,ชุมชนเมือง,249,128,121
1035,จอมทอง,จอมทอง,บ้านสวน,ชุมชนชานเมือง,971,380,591
1035,จอมทอง,จอมทอง,มัสยิดนูรุ้ลย่ากีน,ชุมชนเมือง,1452,695,757
1035,จอมทอง,จอมทอง,รวมใจ,ชุมชนเมือง,482,219,263
1035,จอมทอง,จอมทอง,อุดมสิน 2,ชุมชนเมือง,304,153,151
1035,จอมทอง,จอมทอง,ซอยสุดเขต,ชุมชนเมือง,1228,480,748
1035,จอมทอง,จอมทอง,ภาณุมาภรณ์พัฒนา,ชุมชนเมือง,1214,675,539
1035,จอมทอง,จอมทอง,ซอยปลั่งอนุสรณ์,ชุมชนเมือง,337,145,192
1035,จอมทอง,จอมทอง,เรือนไทยพัฒนา,ชุมชนชานเมือง,511,246,265
1035,จอมทอง,จอมทอง,สามง่ามพัฒนา,ชุมชนชานเมือง,544,253,291
1035,จอมทอง,จอมทอง,จอมทอง,ชุมชนเมือง,705,381,324
1035,จอมทอง,จอมทอง,วัดบางขุนเทียนนอก,ชุมชนเมือง,522,262,260
1035,จอมทอง,จอมทอง,คุณยายวัน,ชุมชนเมือง,796,388,408
1035,จอมทอง,จอมทอง,บางระแนะน้อย,ชุมชนเมือง,568,271,297
1036,ดอนเมือง,สีกัน,ปิ่นเจริญ 2,ชุมชนเมือง,2375,1080,1295
1036,ดอนเมือง,สีกัน,ฝั่งโขงดอนเมือง,ชุมชนเมือง,1363,624,739
1036,ดอนเมือง,สีกัน,วังไพรเวช,ชุมชนเมือง,1540,562,978
1036,ดอนเมือง,สีกัน,นิเวศน์ชาวฟ้า,ชุมชนเมือง,1137,533,604
1036,ดอนเมือง,สีกัน,สหกรณ์เคหสถานครูไทย,ชุมชนเมือง,687,317,370
1036,ดอนเมือง,สีกัน,ปิ่นเจริญ 3,ชุมชนเมือง,2825,1274,1551
1036,ดอนเมือง,สีกัน,เปรมประชา,ชุมชนเมือง,838,370,468
1036,ดอนเมือง,สีกัน,พรหมสัมฤทธิ์ หมู่ 2-3,ชุมชนแออัด,1206,586,620
1036,ดอนเมือง,สีกัน,ปิ่นเจริญ 1,ชุมชนเมือง,2156,1045,1111
1036,ดอนเมือง,สีกัน,หมู่บ้านสินวงศ์,ชุมชนเมือง,1113,517,596
1036,ดอนเมือง,สีกัน,ดาวทอง หมู่ 2,ชุมชนเมือง,1735,848,887
1036,ดอนเมือง,สีกัน,ร่วมใจพัฒนา กรป.กลาง,ชุมชนเมือง,663,317,346
1036,ดอนเมือง,สีกัน,สวนฝรั่ง,ชุมชนเมือง,463,212,251
1036,ดอนเมือง,สีกัน,ร่วมพัฒนา,ชุมชนแออัด,738,383,355
1036,ดอนเมือง,สีกัน,ปิ่นเจริญ 4,ชุมชนเมือง,1384,636,748
1036,ดอนเมือง,สีกัน,อยู่เจริญ-บุญมา,ชุมชนเมือง,1826,891,935
1036,ดอนเมือง,สีกัน,หมู่บ้านวัฒนานนท์,ชุมชนเมือง,402,180,222
1036,ดอนเมือง,สีกัน,นปอ.,ชุมชนเมือง,1132,884,248
1036,ดอนเมือง,สีกัน,ดอนเมืองวิลล่า,ชุมชนเมือง,1302,595,707
1036,ดอนเมือง,สีกัน,อมรพันธุ์,ชุมชนเมือง,884,418,466
1036,ดอนเมือง,สีกัน,ร่วมใจรัก (คลองเปรมประชากร),ชุมชนแออัด,492,234,258
1036,ดอนเมือง,สีกัน,อยู่เจริญ 9 ไร่,ชุมชนเมือง,318,150,168
1036,ดอนเมือง,สีกัน,ศรีสุข-ญาดาร่วมพัฒนา,ชุมชนเมือง,295,132,163
1036,ดอนเมือง,สีกัน,แหลมทองนิเวศน์,ชุมชนเมือง,812,373,439
1036,ดอนเมือง,สีกัน,วัดดอนเมือง (ด้านเมือง),ชุมชนแออัด,973,487,486
1036,ดอนเมือง,สีกัน,ธนิกา,ชุมชนเมือง,457,221,236
1036,ดอนเมือง,สีกัน,ศศิวัลย์เมืองใหม่,ชุมชนเมือง,242,109,133
1036,ดอนเมือง,สีกัน,บ้านไทยเมืองใหม่ดอนเมือง,ชุมชนเมือง,204,92,112
1036,ดอนเมือง,ดอนเมือง,โกสุมรวมใจ 1,ชุมชนเมือง,1868,867,1001
1036,ดอนเมือง,ดอนเมือง,โกสุมรวมใจ 2,ชุมชนเมือง,1349,647,702
1036,ดอนเมือง,ดอนเมือง,บุญมาก,ชุมชนเมือง,713,343,370
1036,ดอนเมือง,ดอนเมือง,ประชาอุทิศม่วงมณีร่วมใจ,ชุมชนเมือง,1134,533,601
1036,ดอนเมือง,ดอนเมือง,แม่ทองก้อน,ชุมชนเมือง,693,352,341
1036,ดอนเมือง,ดอนเมือง,ศรีดอนเมือง,ชุมชนเมือง,1635,748,887
1036,ดอนเมือง,ดอนเมือง,ศิริสุข,ชุมชนเมือง,2521,1214,1307
1036,ดอนเมือง,ดอนเมือง,หน้าท่าอากาศยานด้านใต้,ชุมชนแออัด,379,189,190
1036,ดอนเมือง,ดอนเมือง,หลังวัดไผ่เขียว,ชุมชนเมือง,1132,555,577
1036,ดอนเมือง,ดอนเมือง,สายอำพันธ์-เอมสาร,ชุมชนเมือง,182,91,91
1036,ดอนเมือง,ดอนเมือง,สุวรรณี,ชุมชนเมือง,376,178,198
1036,ดอนเมือง,ดอนเมือง,แก้วงาม,ชุมชนเมือง,251,122,129
1036,ดอนเมือง,ดอนเมือง,ไผ่เขียววิลล่า,ชุมชนเมือง,718,328,390
1036,ดอนเมือง,ดอนเมือง,ศรีกาญจน์,ชุมชนเมือง,931,425,506
1036,ดอนเมือง,ดอนเมือง,ประชากร 3,ชุมชนแออัด,874,425,449
1036,ดอนเมือง,ดอนเมือง,ปู่เจ้าสมิงพรายสะพานปูน,ชุมชนแออัด,551,269,282
1036,ดอนเมือง,ดอนเมือง,พัฒนาตลาดกลาง,ชุมชนแออัด,826,422,404
1036,ดอนเมือง,ดอนเมือง,ร่มไทรงามพัฒนา,ชุมชนแออัด,1267,626,641
1036,ดอนเมือง,ดอนเมือง,ประเสริฐเปรมประชา,ชุมชนแออัด,635,241,394
1036,ดอนเมือง,ดอนเมือง,โกสุมสามัคคี 1,ชุมชนเมือง,1717,752,965
1036,ดอนเมือง,ดอนเมือง,โกสุมสามัคคี 2,ชุมชนเมือง,1291,575,716
1036,ดอนเมือง,ดอนเมือง,พลอยไพลิน,ชุมชนเมือง,376,185,191
1036,ดอนเมือง,ดอนเมือง,สะพานปูน,ชุมชนแออัด,613,276,337
1036,ดอนเมือง,ดอนเมือง,บูรพา 7,ชุมชนเมือง,674,319,355
1036,ดอนเมือง,ดอนเมือง,บูรพา 19,ชุมชนเมือง,334,151,183
1036,ดอนเมือง,ดอนเมือง,รัตนาวลัย หมู่ 1,ชุมชนเมือง,1168,530,638
1036,ดอนเมือง,ดอนเมือง,บูรพา 16,ชุมชนเมือง,1215,560,655
1036,ดอนเมือง,ดอนเมือง,พัฒนาประชาอุทิศ,ชุมชนแออัด,263,124,139
1036,ดอนเมือง,ดอนเมือง,ประชากร 4,ชุมชนแออัด,552,263,289
1036,ดอนเมือง,ดอนเมือง,สะพานร่วมใจ,ชุมชนแออัด,273,149,124
1036,ดอนเมือง,ดอนเมือง,ทำนบร่วมใจ,ชุมชนแออัด,280,135,145
1036,ดอนเมือง,ดอนเมือง,บูรพา 18,ชุมชนเมือง,1152,557,595
1036,ดอนเมือง,ดอนเมือง,หมู่บ้านวัฒนานันท์,ชุมชนเมือง,452,206,246
1036,ดอนเมือง,ดอนเมือง,เทพประทาน,ชุมชนเมือง,587,271,316
1036,ดอนเมือง,ดอนเมือง,โกสุมรวมใจ 3,ชุมชนเมือง,2451,1170,1281
1036,ดอนเมือง,ดอนเมือง,เวียงเทพ 9,ชุมชนเมือง,568,255,313
1036,ดอนเมือง,ดอนเมือง,สตรีเหล็กพัฒนา,ชุมชนแออัด,352,169,183
1036,ดอนเมือง,ดอนเมือง,หมู่บ้านไทยเทยิ่่น,ชุมชนเมือง,164,69,95
1036,ดอนเมือง,ดอนเมือง,สุขวัลย์นคร,ชุมชนเมือง,191,86,105
1036,ดอนเมือง,ดอนเมือง,ปิ่นทอง,ชุมชนเมือง,414,187,227
1036,ดอนเมือง,ดอนเมือง,ปิ่นเงิน,ชุมชนเมือง,356,158,198
1036,ดอนเมือง,ดอนเมือง,อุบล-แอร์พอร์ตสามัคคี,ชุมชนเมือง,684,310,374
1036,ดอนเมือง,ดอนเมือง,หมู่บ้านจักรพงษ์ 3,ชุมชนเมือง,352,159,193
1036,ดอนเมือง,ดอนเมือง,พิณฑุมาธานี,ชุมชนเมือง,207,110,97
1036,ดอนเมือง,ดอนเมือง,ร่มเย็น 1,ชุมชนเมือง,203,106,97
1036,ดอนเมือง,ดอนเมือง,เสริมปรีดี,ชุมชนเมือง,470,243,227
1036,ดอนเมือง,ดอนเมือง,หมู่บ้านแอร์พอร์ตวิลเลจ,ชุมชนเมือง,206,98,108
1036,ดอนเมือง,ดอนเมือง,สวนทองวิล่า 5,ชุมชนเมือง,618,287,331
1036,ดอนเมือง,ดอนเมือง,หมู่บ้านกัญจน์เพรชวิลล่า,ชุมชนเมือง,462,215,247
1036,ดอนเมือง,ดอนเมือง,ป่ากล้วยพัฒนา,ชุมชนเมือง,238,113,125
1036,ดอนเมือง,ดอนเมือง,หมู่บ้านวิภาลัย,ชุมชนเมือง,362,174,188
1036,ดอนเมือง,ดอนเมือง,หมู่บ้านเจริญสุข,ชุมชนเมือง,499,237,262
1036,ดอนเมือง,ดอนเมือง,หมู่บ้านทับแก้วสามัคคี,ชุมชนเมือง,564,270,294
1036,ดอนเมือง,สนามบิน,ธนินทร 1,ชุมชนเมือง,2271,968,1303
1036,ดอนเมือง,สนามบิน,ธนินทร 2,ชุมชนเมือง,199,90,109
1036,ดอนเมือง,สนามบิน,อยู่เจริญ-วิภาวดี,ชุมชนเมือง,2165,961,1204
1036,ดอนเมือง,สนามบิน,ร่วมมิตรแรงศรัทธา,ชุมชนแออัด,1331,653,678
1036,ดอนเมือง,สนามบิน,เจษฎา 1,ชุมชนเมือง,510,238,272
1036,ดอนเมือง,สนามบิน,วังทอง,ชุมชนเมือง,1243,562,681
1036,ดอนเมือง,สนามบิน,ศุภลักษณ์,ชุมชนเมือง,504,210,294
1036,ดอนเมือง,สนามบิน,ทัดชาวิลล่า,ชุมชนเมือง,774,352,422
1036,ดอนเมือง,สนามบิน,บัณฑิตโฮม,ชุมชนเมือง,664,290,374
1036,ดอนเมือง,สนามบิน,บดินทร์เฮาส์,ชุมชนเมือง,204,87,117
1036,ดอนเมือง,สนามบิน,เสริมเพิ่มพูน,ชุมชนเมือง,150,73,77
1036,ดอนเมือง,สนามบิน,หมู่บ้านพิพรพงษ์ 1,ชุมชนเมือง,892,404,488
1036,ดอนเมือง,สนามบิน,ยิ่งโอฬาร,ชุมชนเมือง,693,318,375
1036,ดอนเมือง,สนามบิน,แสงไพฑูรย์,ชุมชนเมือง,1064,477,587
1026,ดินแดง,ดินแดง,ซอยชานเมือง,ชุมชนแออัด,3131,1427,1704
1026,ดินแดง,ดินแดง,ซอยแสนสุข,ชุมชนเมือง,1005,476,529
1026,ดินแดง,ดินแดง,เคหะดินแดง (แฟลต 1-20),ชุมชนอาคารสูง,3282,1490,1792
1026,ดินแดง,ดินแดง,เคหะดินแดง 1 (แฟลต 21-32),ชุมชนอาคารสูง,1598,711,887
1026,ดินแดง,ดินแดง,ซอยผาสุก,ชุมชนเมือง,1169,518,651
1026,ดินแดง,ดินแดง,ซอยนาทอง แยก 1-6,ชุมชนเมือง,936,454,482
1026,ดินแดง,ดินแดง,ซอยสุขใจ,ชุมชนเมือง,198,95,103
1026,ดินแดง,ดินแดง,สวัสดี,ชุมชนเมือง,840,391,449
1026,ดินแดง,รัชดาภิเษก,ซอยแม่เนี้ยว,ชุมชนแออัด,273,123,150
1026,ดินแดง,รัชดาภิเษก,ซอยสมบูรณ์พัฒนา 2,ชุมชนแออัด,102,46,56
1026,ดินแดง,รัชดาภิเษก,ซอยอินทามระ 55,ชุมชนแออัด,233,102,131
1026,ดินแดง,รัชดาภิเษก,ซอยริมคลองบางซื่อ ซอยโชคชัยร่วมมิตร แยก 2 - 4,ชุมชนแออัด,403,183,220
1026,ดินแดง,รัชดาภิเษก,ซอยริมคลองบางซื่อ ซอยโชคชัยร่วมมิตร แยก 18,ชุมชนแออัด,461,243,218
1026,ดินแดง,รัชดาภิเษก,ซอยกุนนที,ชุมชนเมือง,649,299,350
1026,ดินแดง,รัชดาภิเษก,ซอยเพิ่มสิน-สมบูรณ์สุข,ชุมชนเมือง,392,182,210
1026,ดินแดง,รัชดาภิเษก,ซอยแม่เนี้ยว แยก 3,ชุมชนแออัด,1074,510,564
1026,ดินแดง,รัชดาภิเษก,หมู่บ้านอยู่เจริญ (อินทามระ 41),ชุมชนเมือง,145,68,77
1026,ดินแดง,รัชดาภิเษก,หมู่บ้านอยู่เจริญ (โครงการ 3),ชุมชนเมือง,754,369,385
1026,ดินแดง,รัชดาภิเษก,อาคารสงเคราะห์ ฯ ดินแดง,ชุมชนอาคารสูง,228,117,111
1026,ดินแดง,รัชดาภิเษก,ศูนย์การกำลังสำรอง,ชุมชนอาคารสูง,595,346,249
1026,ดินแดง,รัชดาภิเษก,หมู่บ้านอินทามระ ซอย 51,ชุมชนเมือง,1252,599,653
1026,ดินแดง,รัชดาภิเษก,กรมการทหารสื่อสาร ชุมชนที่ 2,ชุมชนอาคารสูง,287,158,129
1002,ดุสิต,ดุสิต,ซอยโซดา,ชุมชนแออัด,679,350,329
1002,ดุสิต,ดุสิต,วัดโบสถ์สามเสน,ชุมชนเมือง,233,132,101
1002,ดุสิต,ดุสิต,สวนอ้อย,ชุมชนเมือง,1156,526,630
1002,ดุสิต,วชิรพยาบาล,ท่าน้ำสามเสน,ชุมชนแออัด,1382,675,707
1002,ดุสิต,วชิรพยาบาล,วัดเทวราชกุญชร,ชุมชนเมือง,564,265,299
1002,ดุสิต,วชิรพยาบาล,ชาววัดราชา,ชุมชนแออัด,285,145,140
1002,ดุสิต,วชิรพยาบาล,ราชผาทับทิมร่วมใจ,ชุมชนแออัด,294,141,153
1002,ดุสิต,สวนจิตรลดา,ข้างวัดสุคันธาราม,ชุมชนแออัด,869,436,433
1002,ดุสิต,สวนจิตรลดา,ถนนสุคันธาราม,ชุมชนเมือง,3950,1985,1965
1002,ดุสิต,สวนจิตรลดา,สุโขทัยซอย 1,ชุมชนเมือง,625,283,342
1002,ดุสิต,สี่แยกมหานาค,หลังบ้านมนังคศิลา,ชุมชนเมือง,821,400,421
1002,ดุสิต,สี่แยกมหานาค,ริมทางรถไฟสายแปดริ้ว,ชุมชนแออัด,1333,647,686
1002,ดุสิต,สี่แยกมหานาค,วัดญวน-คลองลำปัก,ชุมชนเมือง,1017,496,521
1002,ดุสิต,ถนนนครไชยศรี,ซอยราชพัสดุ,ชุมชนเมือง,794,371,423
1002,ดุสิต,ถนนนครไชยศรี,ซอยมิตรอนันต์,ชุมชนเมือง,450,203,247
1002,ดุสิต,ถนนนครไชยศรี,ซอยสันติสุข,ชุมชนเมือง,664,311,353
1002,ดุสิต,ถนนนครไชยศรี,ซอยสีคาม,ชุมชนเมือง,635,315,320
1002,ดุสิต,ถนนนครไชยศรี,ชาวบางกระบือ 14,ชุมชนแออัด,868,408,460
1002,ดุสิต,ถนนนครไชยศรี,พัฒนาซอยสินทรัพย์,ชุมชนเมือง,900,300,600
1002,ดุสิต,ถนนนครไชยศรี,วัดสวัสดิ์วารีสีมาราม,ชุมชนเมือง,538,232,306
1002,ดุสิต,ถนนนครไชยศรี,พัฒนาซอยระนองกลาง,ชุมชนแออัด,452,226,226
1002,ดุสิต,ถนนนครไชยศรี,บ้านพักองค์การทอผ้า,ชุมชนเมือง,504,196,308
1002,ดุสิต,ถนนนครไชยศรี,วัดประชาระบือธรรม 1,ชุมชนเมือง,780,360,420
1002,ดุสิต,ถนนนครไชยศรี,วัดประชาระบือธรรม 2,ชุมชนเมือง,757,363,394
1002,ดุสิต,ถนนนครไชยศรี,วัดประชาระบือธรรม 3,ชุมชนเมือง,578,270,308
1002,ดุสิต,ถนนนครไชยศรี,วัดประชาระบือธรรม 4,ชุมชนแออัด,295,136,159
1002,ดุสิต,ถนนนครไชยศรี,พระยาประสิทธิ์,ชุมชนเมือง,702,332,370
1002,ดุสิต,ถนนนครไชยศรี,ซอยเสริมสุข,ชุมชนเมือง,454,213,241
1002,ดุสิต,ถนนนครไชยศรี,วัดน้อยนพคุณ,ชุมชนเมือง,1114,553,561
1002,ดุสิต,ถนนนครไชยศรี,นครไชยศรี,ชุมชนเมือง,400,150,250
1002,ดุสิต,ถนนนครไชยศรี,ศรีย่านซอย 3,ชุมชนเมือง,397,195,202
1002,ดุสิต,ถนนนครไชยศรี,พล ปตอ. พื้นที่เกียกกาย,ชุมชนเมือง,1113,766,347
1002,ดุสิต,ถนนนครไชยศรี,พิชัย,ชุมชนอาคารสูง,150,69,81
1002,ดุสิต,ถนนนครไชยศรี,ปืนหนึ่ง,ชุมชนอาคารสูง,423,260,163
1002,ดุสิต,ถนนนครไชยศรี,สรรพาวุธนิเวศน์,ชุมชนเมือง,381,200,181
1002,ดุสิต,ถนนนครไชยศรี,ม.พัน 3 รอ.,ชุมชนอาคารสูง,1173,939,234
1002,ดุสิต,ถนนนครไชยศรี,ตรอกต้นโพธิ์,ชุมชนเมือง,464,209,255
1002,ดุสิต,ถนนนครไชยศรี,ม้าหนึ่ง,ชุมชนอาคารสูง,504,426,78
1002,ดุสิต,ถนนนครไชยศรี,กรมสรรพาวุธทหารบก,ชุมชนอาคารสูง,1225,581,644
1002,ดุสิต,ถนนนครไชยศรี,บ้านพัก ขส.ทบ.สะพานแดง,ชุมชนอาคารสูง,1286,850,436
1002,ดุสิต,ถนนนครไชยศรี,สื่อสารสะพานแดง,ชุมชนเมือง,974,576,398
1002,ดุสิต,ถนนนครไชยศรี,ม.พัน 4 รอ.,ชุมชนอาคารสูง,658,361,297
1002,ดุสิต,ถนนนครไชยศรี,แฟลตสิริสาสน์ เคหะศรีย่าน,ชุมชนอาคารสูง,575,251,324
1019,ตลิ่งชัน,คลองชักพระ,ริมคลองชักพระ,ชุมชนเมือง,132,49,83
1019,ตลิ่งชัน,คลองชักพระ,วัดช่างเหล็ก-วัดเรไร,ชุมชนแออัด,2010,774,1236
1019,ตลิ่งชัน,คลองชักพระ,หลังวัดกาญจนสิงหาสน์,ชุมชนแออัด,185,92,93
1019,ตลิ่งชัน,คลองชักพระ,วัดปากน้ำฝั่งเหนือ,ชุมชนชานเมือง,436,216,220
1019,ตลิ่งชัน,คลองชักพระ,สองแขวง,ชุมชนชานเมือง,490,216,274
1019,ตลิ่งชัน,คลองชักพระ,บ้านคู่คลอง,ชุมชนชานเมือง,408,161,247
1019,ตลิ่งชัน,ตลิ่งชัน,ซอยพฤกษอุดม - วัดน้อยใน,ชุมชนเมือง,418,198,220
1019,ตลิ่งชัน,ตลิ่งชัน,วัดชัยพฤกษมาลา,ชุมชนแออัด,1969,890,1079
1019,ตลิ่งชัน,ตลิ่งชัน,ศาลเจ้าพ่อจุ้ย,ชุมชนชานเมือง,450,205,245
1019,ตลิ่งชัน,ตลิ่งชัน,สะพานผัก - คลองศาลเจ้า,ชุมชนแออัด,1005,400,605
1019,ตลิ่งชัน,ตลิ่งชัน,ริมทางรถไฟชัยพฤกษ์,ชุมชนชานเมือง,632,270,362
1019,ตลิ่งชัน,ตลิ่งชัน,บ้านลุ่ม,ชุมชนแออัด,390,190,200
1019,ตลิ่งชัน,ตลิ่งชัน,โรงเรียนวัดตลิ่งชัน,ชุมชนแออัด,385,189,196
1019,ตลิ่งชัน,ตลิ่งชัน,หลังวัดไก่เตี้ย,ชุมชนเมือง,300,157,143
1019,ตลิ่งชัน,ฉิมพลี,วัดกระจัง,ชุมชนชานเมือง,542,249,293
1019,ตลิ่งชัน,ฉิมพลี,วัดมณฑป,ชุมชนชานเมือง,1278,560,718
1019,ตลิ่งชัน,ฉิมพลี,หมู่บ้านพัฒนา หมู่ 7 ฉิมพลี,ชุมชนชานเมือง,630,235,395
1019,ตลิ่งชัน,ฉิมพลี,วัดสมรโกฏิ-บางระจัน,ชุมชนชานเมือง,587,266,321
1019,ตลิ่งชัน,ฉิมพลี,หมู่บ้าน 2521,ชุมชนเมือง,306,133,173
1019,ตลิ่งชัน,ฉิมพลี,ฉิมพลี,ชุมชนชานเมือง,956,363,593
1019,ตลิ่งชัน,ฉิมพลี,วัดทองบางระมาด หมู่ที่ 10,ชุมชนชานเมือง,581,202,379
1019,ตลิ่งชัน,บางพรม,ศาลาหลังบ้าน,ชุมชนชานเมือง,450,230,220
1019,ตลิ่งชัน,บางพรม,"หมู่ 1,3 แขวงบางพรม",ชุมชนชานเมือง,2100,820,1280
1019,ตลิ่งชัน,บางพรม,หลังวัดรัชฎาธิษฐาน (วัดเงิน),ชุมชนแออัด,695,325,370
1019,ตลิ่งชัน,บางพรม,วัดเพลงกลางสวน,ชุมชนชานเมือง,309,162,147
1019,ตลิ่งชัน,บางพรม,โค้งเอส,ชุมชนชานเมือง,447,204,243
1019,ตลิ่งชัน,บางพรม,ราชพฤกษ์,ชุมชนชานเมือง,533,264,269
1019,ตลิ่งชัน,บางพรม,หมู่ 12 บ้านสวนบางพรม,ชุมชนชานเมือง,320,147,173
1019,ตลิ่งชัน,บางพรม,หมู่ที่ 5 บางพรม,ชุมชนชานเมือง,850,340,510
1019,ตลิ่งชัน,บางระมาด,วัดจำปา,ชุมชนชานเมือง,670,254,416
1019,ตลิ่งชัน,บางระมาด,วัดมะกอก,ชุมชนแออัด,245,103,142
1019,ตลิ่งชัน,บางระมาด,หมู่บ้านพัฒนา หมู่ 13 แขวงบางระมาด,ชุมชนชานเมือง,282,118,164
1019,ตลิ่งชัน,บางระมาด,หมู่บ้านพัฒนา หมู่ 4 แขวงบางระมาด,ชุมชนชานเมือง,560,276,284
1019,ตลิ่งชัน,บางระมาด,หมู่บ้านพัฒนาวัดกาญจนสิงหาสน์ (1819),ชุมชนชานเมือง,1900,795,1105
1019,ตลิ่งชัน,บางระมาด,หมู่ 6,ชุมชนชานเมือง,412,199,213
1019,ตลิ่งชัน,บางระมาด,บ้านไทร,ชุมชนชานเมือง,455,215,240
1019,ตลิ่งชัน,บางระมาด,หมู่บ้านพัฒนาวัดอินทราวาส 1,ชุมชนเมือง,1908,697,1211
1019,ตลิ่งชัน,บางระมาด,หมู่บ้านพัฒนาวัดอินทราวาส 2,ชุมชนชานเมือง,497,239,258
1019,ตลิ่งชัน,บางระมาด,หมู่บ้านมหาดไทย 1,ชุมชนเมือง,1540,551,989
1019,ตลิ่งชัน,บางเชือกหนัง,วัดเกาะ,ชุมชนชานเมือง,526,251,275
1019,ตลิ่งชัน,บางเชือกหนัง,คลองบางน้อย,ชุมชนชานเมือง,309,166,143
1019,ตลิ่งชัน,บางเชือกหนัง,หมู่ 8 วัดทองบางเชือกหนัง,ชุมชนเมือง,393,188,205
1019,ตลิ่งชัน,บางเชือกหนัง,ทรัพย์สินพัฒนา,ชุมชนเมือง,243,103,140
1048,ทวีวัฒนา,ทวีวัฒนา,หมู่บ้านร่วมเกื้อ,ชุมชนเมือง,3287,1610,1677
1048,ทวีวัฒนา,ทวีวัฒนา,หมู่บ้านสินพัฒนาธานี,ชุมชนเมือง,1787,827,960
1048,ทวีวัฒนา,ทวีวัฒนา,บางพรหมร่วมใจ,ชุมชนชานเมือง,1435,697,738
1048,ทวีวัฒนา,ทวีวัฒนา,คลองเนินทราย,ชุมชนชานเมือง,721,375,346
1048,ทวีวัฒนา,ทวีวัฒนา,ศรีมณฑลสามัคคี,ชุมชนเมือง,635,284,351
1048,ทวีวัฒนา,ทวีวัฒนา,ทวีวัฒนา 25,ชุมชนเมือง,1118,521,597
1048,ทวีวัฒนา,ศาลาธรรมสพน์,ประตูน้ำฉิมพลี,ชุมชนชานเมือง,900,422,478
1048,ทวีวัฒนา,ศาลาธรรมสพน์,วัดปุรณาวาส,ชุมชนชานเมือง,1043,504,539
1048,ทวีวัฒนา,ศาลาธรรมสพน์,หลังสถานีรถไฟศาลาธรรมสพน์,ชุมชนชานเมือง,676,329,347
1048,ทวีวัฒนา,ศาลาธรรมสพน์,หมู่บ้านสุขทวี 1-2,ชุมชนเมือง,708,329,379
1048,ทวีวัฒนา,ศาลาธรรมสพน์,หมู่บ้านกอบแก้ว 1,ชุมชนเมือง,218,92,126
1048,ทวีวัฒนา,ศาลาธรรมสพน์,หมู่บ้านพรรณพฤกษา,ชุมชนเมือง,683,317,366
1048,ทวีวัฒนา,ศาลาธรรมสพน์,เจ้าพระยาร่วมใจ,ชุมชนเมือง,905,429,476
1048,ทวีวัฒนา,ศาลาธรรมสพน์,บ้านจัดสรรสกุลทิพย์,ชุมชนเมือง,1008,464,544
1048,ทวีวัฒนา,ศาลาธรรมสพน์,พัฒนาหมู่บ้านเปรมวดี,ชุมชนเมือง,1006,483,523
1048,ทวีวัฒนา,ศาลาธรรมสพน์,คลองมหาสวัสดิ์,ชุมชนชานเมือง,470,240,230
1049,ทุ่งครุ,บางมด,บูลไลท์,ชุมชนเมือง,894,420,474
1049,ทุ่งครุ,บางมด,อัตตักวา,ชุมชนเมือง,450,199,251
1049,ทุ่งครุ,บางมด,หมู่ 2 บางมด,ชุมชนเมือง,876,438,438
1049,ทุ่งครุ,บางมด,หมู่ 3 บางมด,ชุมชนชานเมือง,363,136,227
1049,ทุ่งครุ,บางมด,หมู่ 5 บางมด,ชุมชนเมือง,179,72,107
1049,ทุ่งครุ,บางมด,ศรีสมิต,ชุมชนเมือง,418,196,222
1049,ทุ่งครุ,บางมด,สามัคคี,ชุมชนเมือง,867,452,415
1049,ทุ่งครุ,บางมด,หลังสวนธนบุรีรมย์,ชุมชนชานเมือง,1036,519,517
1049,ทุ่งครุ,บางมด,ประชาอุทิศ 43,ชุมชนเมือง,536,265,271
1049,ทุ่งครุ,บางมด,ร่วมใจพัฒนา,ชุมชนเมือง,858,404,454
1049,ทุ่งครุ,บางมด,หลังวัดกลางนา,ชุมชนเมือง,602,311,291
1049,ทุ่งครุ,บางมด,นูรุ้ลฮุดา,ชุมชนเมือง,379,181,198
1049,ทุ่งครุ,บางมด,มิตรไมตรี,ชุมชนเมือง,1258,535,723
1049,ทุ่งครุ,บางมด,มติมิตร,ชุมชนเมือง,537,260,277
1049,ทุ่งครุ,ทุ่งครุ,ชุมชนชานเมือง หมู่ 6 ทุ่งครุ,ชุมชนเมือง,1845,1035,810
1049,ทุ่งครุ,ทุ่งครุ,หลังสน. ทุ่งครุ,ชุมชนเมือง,259,124,135
1049,ทุ่งครุ,ทุ่งครุ,ชุมชนซอยชมทรัพย์,ชุมชนเมือง,4202,2040,2162
1049,ทุ่งครุ,ทุ่งครุ,ชุมชนชานเมือง หมู่ 5 ทุ่งครุ,ชุมชนเมือง,1410,719,691
1049,ทุ่งครุ,ทุ่งครุ,คลองเก้าห้อง,ชุมชนเมือง,709,333,376
1049,ทุ่งครุ,ทุ่งครุ,ประชาอุทิศ 68,ชุมชนเมือง,1374,683,691
1049,ทุ่งครุ,ทุ่งครุ,ดารีซีน,ชุมชนเมือง,403,230,173
1049,ทุ่งครุ,ทุ่งครุ,ทุ่งครุพัฒนา,ชุมชนเมือง,267,122,145
1049,ทุ่งครุ,ทุ่งครุ,คอลิดีน,ชุมชนเมือง,1308,620,688
1049,ทุ่งครุ,ทุ่งครุ,ใต้สะพานโซน 1,ชุมชนแออัด,557,273,284
1049,ทุ่งครุ,ทุ่งครุ,สน.ทุ่งครุ,ชุมชนอาคารสูง,463,213,250
1049,ทุ่งครุ,ทุ่งครุ,ดารุ้ลอิบาดะฮ์,ชุมชนชานเมือง,180,73,107
1049,ทุ่งครุ,ทุ่งครุ,ชุมชนร่วมรัฐสามัคคี (ดอนกระต่าย),ชุมชนเมือง,367,169,198
1049,ทุ่งครุ,ทุ่งครุ,อาคารสงเคราะห์ฯ ซอยประชาอุทิศ 90,ชุมชนอาคารสูง,592,309,283
1049,ทุ่งครุ,ทุ่งครุ,คลองรางจาก,ชุมชนเมือง,404,213,191
1015,ธนบุรี,วัดกัลยาณ์,กุฎีขาว,ชุมชนแออัด,1103,477,626
1015,ธนบุรี,วัดกัลยาณ์,กุฎีจีน,ชุมชนแออัด,943,428,515
1015,ธนบุรี,วัดกัลยาณ์,โรงคราม,ชุมชนแออัด,442,196,246
1015,ธนบุรี,วัดกัลยาณ์,วัดกัลยาณ์,ชุมชนแออัด,1119,515,604
1015,ธนบุรี,วัดกัลยาณ์,วัดบุปผาราม,ชุมชนแออัด,1016,476,540
1015,ธนบุรี,วัดกัลยาณ์,วัดประยุรวงศ์,ชุมชนแออัด,983,439,544
1015,ธนบุรี,หิรัญรูจี,บางไส้ไก่บ้านสมเด็จ,ชุมชนแออัด,662,303,359
1015,ธนบุรี,หิรัญรูจี,มัสยิดบ้านสมเด็จ,ชุมชนแออัด,1027,472,555
1015,ธนบุรี,หิรัญรูจี,วัดประดิษฐาราม,ชุมชนแออัด,777,360,417
1015,ธนบุรี,หิรัญรูจี,วัดใหญ่ศรีสุพรรณ,ชุมชนแออัด,1286,620,666
1015,ธนบุรี,หิรัญรูจี,ซอยศรีภูมิ,ชุมชนแออัด,1149,553,596
1015,ธนบุรี,หิรัญรูจี,สามัคคีศรีสุพรรณ,ชุมชนแออัด,300,154,146
1015,ธนบุรี,หิรัญรูจี,สี่แยกบ้านแขก,ชุมชนแออัด,676,293,383
1015,ธนบุรี,หิรัญรูจี,ประสานมิตร,ชุมชนแออัด,1241,586,655
1015,ธนบุรี,หิรัญรูจี,วัดหิรัญรูจี,ชุมชนแออัด,1529,747,782
1015,ธนบุรี,บางยี่เรือ,ข้างสถานีรถไฟวงเวียนใหญ่,ชุมชนแออัด,1469,692,777
1015,ธนบุรี,บางยี่เรือ,ตรอกเทวดา,ชุมชนแออัด,1476,705,771
1015,ธนบุรี,บางยี่เรือ,ตากสินสัมพันธ์,ชุมชนแออัด,2530,1214,1316
1015,ธนบุรี,บางยี่เรือ,พัฒนาบ้านล่าง,ชุมชนแออัด,1072,551,521
1015,ธนบุรี,บางยี่เรือ,โรงเจ 1,ชุมชนแออัด,1128,500,628
1015,ธนบุรี,บางยี่เรือ,วัดอินทาราม,ชุมชนแออัด,457,250,207
1015,ธนบุรี,บางยี่เรือ,สวนพลู,ชุมชนแออัด,2362,1165,1197
1015,ธนบุรี,บางยี่เรือ,หลังศูนย์จันทร์ฉิมไพบูลย์,ชุมชนแออัด,610,290,320
1015,ธนบุรี,บางยี่เรือ,โรงเจ 2,ชุมชนแออัด,2166,1030,1136
1015,ธนบุรี,บุคคโล,สนามแดง,ชุมชนแออัด,0,0,0
1015,ธนบุรี,บุคคโล,สองร้อยห้อง,ชุมชนแออัด,1854,902,952
1015,ธนบุรี,บุคคโล,สายสัมพันธ์,ชุมชนแออัด,1371,645,726
1015,ธนบุรี,ตลาดพลู,วัดบางสะแกใน,ชุมชนแออัด,628,290,338
1015,ธนบุรี,ตลาดพลู,วัดใหม่ยายนุ้ย,ชุมชนแออัด,459,241,218
1015,ธนบุรี,ตลาดพลู,ซอยสามัคคีธรรม,ชุมชนแออัด,472,224,248
1015,ธนบุรี,ตลาดพลู,ปากคลองบางสะแก,ชุมชนแออัด,1083,503,580
1015,ธนบุรี,ตลาดพลู,วัดกันตทาราราม,ชุมชนแออัด,1003,478,525
1015,ธนบุรี,ดาวคะนอง,โกวบ๊อพัฒนา,ชุมชนแออัด,4148,2025,2123
1015,ธนบุรี,ดาวคะนอง,เจริญนคร 66,ชุมชนแออัด,468,214,254
1015,ธนบุรี,ดาวคะนอง,ตรอกสะพานยาว,ชุมชนแออัด,1713,829,884
1015,ธนบุรี,ดาวคะนอง,มะนาวหวาน,ชุมชนแออัด,377,180,197
1015,ธนบุรี,ดาวคะนอง,วัดดาวคนอง,ชุมชนแออัด,826,383,443
1015,ธนบุรี,สำเหร่,เกื้อวิทยา,ชุมชนแออัด,727,352,375
1015,ธนบุรี,สำเหร่,วัดบางน้ำชน,ชุมชนแออัด,160,60,100
1015,ธนบุรี,สำเหร่,วัดราชวรินทร์,ชุมชนแออัด,1352,622,730
1015,ธนบุรี,สำเหร่,สุทธาราม,ชุมชนแออัด,935,407,528
1015,ธนบุรี,สำเหร่,หลังไปรษณีย์สำเหร่,ชุมชนแออัด,304,147,157
1020,บางกอกน้อย,ศิริราช,ตรอกวังหลัง,ชุมชนแออัด,3800,1810,1990
1020,บางกอกน้อย,ศิริราช,วัดระฆัง,ชุมชนแออัด,1810,830,980
1020,บางกอกน้อย,ศิริราช,วัดสุวรรณาราม,ชุมชนแออัด,4172,1791,2381
1020,บางกอกน้อย,ศิริราช,สันติสุข,ชุมชนแออัด,440,170,270
1020,บางกอกน้อย,ศิริราช,วัดวิเศษการ - วัดฉิมทายกาวาส,ชุมชนเมือง,1259,463,796
1020,บางกอกน้อย,บ้านช่างหล่อ,ซอยบ้านช่างหล่อ,ชุมชนแออัด,1170,541,629
1020,บางกอกน้อย,บ้านช่างหล่อ,ตรอกข้าวเม่า,ชุมชนแออัด,2782,1213,1569
1020,บางกอกน้อย,บ้านช่างหล่อ,วัดครุฑ,ชุมชนแออัด,2900,1263,1637
1020,บางกอกน้อย,บ้านช่างหล่อ,วัดดงมูลเหล็ก,ชุมชนแออัด,18000,8000,10000
1020,บางกอกน้อย,บ้านช่างหล่อ,วัดพระยาทำ,ชุมชนแออัด,558,261,297
1020,บางกอกน้อย,บ้านช่างหล่อ,วัดโพธิ์เรียง,ชุมชนแออัด,7200,3000,4200
1020,บางกอกน้อย,บ้านช่างหล่อ,วัดยางสุทธาราม,ชุมชนแออัด,8000,4000,4000
1020,บางกอกน้อย,บ้านช่างหล่อ,วัดอมรทายิการาม,ชุมชนแออัด,636,219,417
1020,บางกอกน้อย,บ้านช่างหล่อ,วัดอัมพวา,ชุมชนแออัด,7000,3000,4000
1020,บางกอกน้อย,บ้านช่างหล่อ,เหนือวัดสีหไกรสร,ชุมชนแออัด,512,249,263
1020,บางกอกน้อย,บ้านช่างหล่อ,เคหะสน. บางกอกน้อย,ชุมชนอาคารสูง,200,100,100
1020,บางกอกน้อย,บ้านช่างหล่อ,ซอยสุดสาคร,ชุมชนแออัด,1288,615,673
1020,บางกอกน้อย,บ้านช่างหล่อ,พรพิพัฒน์,ชุมชนเมือง,1500,700,800
1020,บางกอกน้อย,บางขุนนนท์,ชวนชื่น,ชุมชนแออัด,438,238,200
1020,บางกอกน้อย,บางขุนนนท์,วัดใหม่ยายแป้น,ชุมชนแออัด,524,218,306
1020,บางกอกน้อย,บางขุนศรี,ซอยประชาร่วมใจ,ชุมชนแออัด,1960,1031,929
1020,บางกอกน้อย,บางขุนศรี,ตรอกไผ่-วัดบางเสาธง,ชุมชนแออัด,12098,5528,6570
1020,บางกอกน้อย,บางขุนศรี,วัดไชยทิศ,ชุมชนแออัด,1615,665,950
1020,บางกอกน้อย,บางขุนศรี,ปลายซอยจรัญสนิทวงศ์ 29 (ฝั่งขวา),ชุมชนแออัด,1076,495,581
1020,บางกอกน้อย,บางขุนศรี,ปลายซอยจรัญสนิทวงศ์ 29 (ฝั่งซ้าย),ชุมชนแออัด,348,143,205
1020,บางกอกน้อย,บางขุนศรี,วัดมะลิ 1 (เจือ เชื่อมจิตต์),ชุมชนแออัด,1056,397,659
1020,บางกอกน้อย,บางขุนศรี,วัดมะลิ 2 (เจือ เชื่อมจิตต์),ชุมชนแออัด,1015,417,598
1020,บางกอกน้อย,บางขุนศรี,วัดรวกสุทธาราม,ชุมชนแออัด,3425,1200,2225
1020,บางกอกน้อย,บางขุนศรี,หลังตลาดนครหลวง,ชุมชนแออัด,845,446,399
1020,บางกอกน้อย,บางขุนศรี,ซอยบุบผาสวรรค์,ชุมชนเมือง,7729,3493,4236
1020,บางกอกน้อย,บางขุนศรี,จรัญสามสิบเอ็ดรวมใจ,ชุมชนเมือง,1513,607,906
1020,บางกอกน้อย,บางขุนศรี,คลองล่าง,ชุมชนแออัด,1214,502,712
1020,บางกอกน้อย,อรุณอมรินทร์,สวนหลวง,ชุมชนแออัด,328,130,198
1020,บางกอกน้อย,อรุณอมรินทร์,สันติชนสงเคราะห์,ชุมชนแออัด,1440,620,820
1020,บางกอกน้อย,อรุณอมรินทร์,ซอยจรัญสนิทวงศ์ 41,ชุมชนเมือง,1696,764,932
1020,บางกอกน้อย,อรุณอมรินทร์,มัสยิดหลวงอันซอริซซุนนะห์,ชุมชนแออัด,330,167,163
1016,บางกอกใหญ่,วัดอรุณ,ข้างโรงเรียนพณิชยการราชดำเนิน,ชุมชนแออัด,487,225,262
1016,บางกอกใหญ่,วัดอรุณ,ปรกอรุณ,ชุมชนแออัด,1176,535,641
1016,บางกอกใหญ่,วัดอรุณ,ลานมะขาม,ชุมชนแออัด,756,313,443
1016,บางกอกใหญ่,วัดอรุณ,วัดหงส์รัตนาราม,ชุมชนแออัด,2067,1023,1044
1016,บางกอกใหญ่,วัดอรุณ,วัดโมลีโลกยาราม,ชุมชนแออัด,300,110,190
1016,บางกอกใหญ่,วัดอรุณ,วัดเครือวัลย์,ชุมชนแออัด,442,216,226
1016,บางกอกใหญ่,วัดอรุณ,วัดนาคกลาง,ชุมชนแออัด,736,350,386
1016,บางกอกใหญ่,วัดท่าพระ,ข้างโรงเรียนเสสะเวช,ชุมชนแออัด,289,125,164
1016,บางกอกใหญ่,วัดท่าพระ,โค้งกระเทียม,ชุมชนแออัด,674,301,373
1016,บางกอกใหญ่,วัดท่าพระ,ซอยสมบุญพัฒนา,ชุมชนแออัด,348,176,172
1016,บางกอกใหญ่,วัดท่าพระ,ตรอกกระจก,ชุมชนแออัด,225,103,122
1016,บางกอกใหญ่,วัดท่าพระ,ปลายซอยศักดิ์เจริญ,ชุมชนแออัด,261,126,135
1016,บางกอกใหญ่,วัดท่าพระ,เพชรเกษม 1,ชุมชนแออัด,351,187,164
1016,บางกอกใหญ่,วัดท่าพระ,ริมคลองบางกอกใหญ่,ชุมชนแออัด,143,65,78
1016,บางกอกใหญ่,วัดท่าพระ,วัดดีดวด,ชุมชนแออัด,347,116,231
1016,บางกอกใหญ่,วัดท่าพระ,วัดท่าพระ,ชุมชนแออัด,837,318,519
1016,บางกอกใหญ่,วัดท่าพระ,วัดประดู่ฉิมพลี,ชุมชนแออัด,201,95,106
1016,บางกอกใหญ่,วัดท่าพระ,วัดใหม่พิเรนทร์,ชุมชนแออัด,973,580,393
1016,บางกอกใหญ่,วัดท่าพระ,ศาลเจ้าพ่อเขาตก,ชุมชนแออัด,779,279,500
1016,บางกอกใหญ่,วัดท่าพระ,หลังโรงกรองน้ำภาษีเจริญ,ชุมชนแออัด,820,436,384
1016,บางกอกใหญ่,วัดท่าพระ,หลังโรงเคลือบ,ชุมชนแออัด,363,160,203
1016,บางกอกใหญ่,วัดท่าพระ,หลังโรงเรียนเสสะเวช,ชุมชนแออัด,453,220,233
1016,บางกอกใหญ่,วัดท่าพระ,วัดสังข์กระจาย,ชุมชนแออัด,386,172,214
1016,บางกอกใหญ่,วัดท่าพระ,วัดใหม่วิเชียร,ชุมชนแออัด,423,201,222
1016,บางกอกใหญ่,วัดท่าพระ,หลังวัดใหม่วิเชียร,ชุมชนแออัด,286,109,177
1016,บางกอกใหญ่,วัดท่าพระ,ซอยจำเนียรสุข 3,ชุมชนแออัด,695,282,413
1016,บางกอกใหญ่,วัดท่าพระ,รวมพล,ชุมชนเมือง,355,173,182
1016,บางกอกใหญ่,วัดท่าพระ,ตรอกตาแทน,ชุมชนแออัด,453,217,236
1016,บางกอกใหญ่,วัดท่าพระ,สัมพันธ์,ชุมชนเมือง,348,171,177
1006,บางกะปิ,คลองจั่น,สุขเจริญพัฒนา,ชุมชนเมือง,810,385,425
1006,บางกะปิ,คลองจั่น,สุขสันต์ 26,ชุมชนเมือง,1041,518,523
1006,บางกะปิ,คลองจั่น,101 บึงทองหลาง,ชุมชนเมือง,760,280,480
1006,บางกะปิ,คลองจั่น,โครงการร่วมกันสร้าง,ชุมชนเมือง,509,249,260
1006,บางกะปิ,คลองจั่น,วัดกลาง,ชุมชนเมือง,1240,590,650
1006,บางกะปิ,คลองจั่น,หมู่บ้านสินธร,ชุมชนเมือง,2784,1225,1559
1006,บางกะปิ,คลองจั่น,หมู่บ้านพัฒนาหมู่ 8,ชุมชนเมือง,605,288,317
1006,บางกะปิ,คลองจั่น,หมู่บ้านเทพทวี,ชุมชนเมือง,765,380,385
1006,บางกะปิ,คลองจั่น,มหาดไทย 2,ชุมชนเมือง,710,312,398
1006,บางกะปิ,คลองจั่น,ไขศรีปราโมชพัฒนา,ชุมชนเมือง,989,522,467
1006,บางกะปิ,คลองจั่น,หมู่บ้านศูนย์เยาวชนคลองจั่น,ชุมชนเมือง,1250,500,750
1006,บางกะปิ,คลองจั่น,หมู่บ้านรัชธานี,ชุมชนเมือง,654,288,366
1006,บางกะปิ,คลองจั่น,ร่วมใจพัฒนา,ชุมชนเมือง,494,186,308
1006,บางกะปิ,หัวหมาก,เยรูซาเล็ม,ชุมชนเมือง,1175,655,520
1006,บางกะปิ,หัวหมาก,วังโสม,ชุมชนแออัด,2252,1292,960
1006,บางกะปิ,หัวหมาก,ริมคลองกระจะ,ชุมชนแออัด,521,272,249
1006,บางกะปิ,หัวหมาก,หมู่บ้านกิตตินิเวศน์,ชุมชนเมือง,3084,1426,1658
1006,บางกะปิ,หัวหมาก,ซอยรามคำแหง 68,ชุมชนเมือง,1064,436,628
1006,บางกะปิ,หัวหมาก,หมู่บ้านสวนสน,ชุมชนเมือง,760,327,433
1006,บางกะปิ,หัวหมาก,สามัคคีพัฒนา,ชุมชนแออัด,1712,790,922
1006,บางกะปิ,หัวหมาก,หมู่บ้านอยู่สบาย,ชุมชนเมือง,252,102,150
1006,บางกะปิ,หัวหมาก,ลำสาลี,ชุมชนแออัด,1135,400,735
1006,บางกะปิ,หัวหมาก,ลำสาลีพัฒนา,ชุมชนแออัด,1724,803,921
1006,บางกะปิ,หัวหมาก,มัจฉา,ชุมชนแออัด,361,153,208
1006,บางกะปิ,หัวหมาก,ประชาร่วมใจ,ชุมชนชานเมือง,697,315,382
1006,บางกะปิ,หัวหมาก,วังใหญ่,ชุมชนแออัด,366,171,195
1006,บางกะปิ,หัวหมาก,ริมคลองหัวหมากน้อย,ชุมชนแออัด,493,237,256
1021,บางขุนเทียน,ท่าข้าม,หมู่บ้านวงแหวนทวีสุข,ชุมชนเมือง,3925,2149,1776
1021,บางขุนเทียน,ท่าข้าม,ทรัพย์นุกูล,ชุมชนเมือง,210,106,104
1021,บางขุนเทียน,ท่าข้าม,วัดกก,ชุมชนเมือง,1384,683,701
1021,บางขุนเทียน,ท่าข้าม,วัดบัวผัน,ชุมชนชานเมือง,1200,500,700
1021,บางขุนเทียน,ท่าข้าม,วัดหัวกระบือ,ชุมชนชานเมือง,1955,905,1050
1021,บางขุนเทียน,ท่าข้าม,ศาลเจ้าแม่ทับทิม หมู่ที่ 5,ชุมชนชานเมือง,1340,746,594
1021,บางขุนเทียน,ท่าข้าม,หมู่บ้านพัฒนา หมู่ที่ 6,ชุมชนชานเมือง,1660,840,820
1021,บางขุนเทียน,ท่าข้าม,หลวงพ่อขาว,ชุมชนเมือง,245,86,159
1021,บางขุนเทียน,ท่าข้าม,"คลองพิทยาลงกรณ์ หมู่ 9 , หมู่ 10",ชุมชนชานเมือง,402,176,226
1021,บางขุนเทียน,ท่าข้าม,หัวป่า หมู่ที่8,ชุมชนชานเมือง,500,265,235
1021,บางขุนเทียน,ท่าข้าม,บางเพนียง,ชุมชนชานเมือง,234,117,117
1021,บางขุนเทียน,ท่าข้าม,คลองใหญ่,ชุมชนแออัด,572,282,290
1021,บางขุนเทียน,ท่าข้าม,คลองรางยายเพียร (กลางทุ่ง),ชุมชนชานเมือง,203,119,84
1021,บางขุนเทียน,ท่าข้าม,เชิงตาแพ (ศิษย์พ่อเสาธง),ชุมชนชานเมือง,200,90,110
1021,บางขุนเทียน,ท่าข้าม,"คลองสาม หมู่ที่ 9 , 10",ชุมชนชานเมือง,650,300,350
1021,บางขุนเทียน,ท่าข้าม,แสนตอ หมู่ที่ 9,ชุมชนชานเมือง,132,67,65
1021,บางขุนเทียน,ท่าข้าม,หลวงพ่อเต่า,ชุมชนชานเมือง,654,304,350
1021,บางขุนเทียน,ท่าข้าม,ชายทะเล-บางขุนเทียน หมู่ที่ 9,ชุมชนชานเมือง,423,155,268
1021,บางขุนเทียน,ท่าข้าม,เสาธง หมู่ที่ 10,ชุมชนชานเมือง,130,70,60
1021,บางขุนเทียน,ท่าข้าม,วัดประชาบำรุง (วัดลูกวัว),ชุมชนชานเมือง,420,200,220
1021,บางขุนเทียน,ท่าข้าม,ศรีกุมาร หมู่ที่ 10,ชุมชนชานเมือง,170,80,90
1021,บางขุนเทียน,แสมดำ,จุลพงษ์,ชุมชนเมือง,2543,1358,1185
1021,บางขุนเทียน,แสมดำ,ซอยนายเจียก,ชุมชนเมือง,425,211,214
1021,บางขุนเทียน,แสมดำ,ทรัพย์สินพัฒนา,ชุมชนเมือง,2800,1599,1201
1021,บางขุนเทียน,แสมดำ,บางกระดี่ หมู่ 2,ชุมชนเมือง,612,323,289
1021,บางขุนเทียน,แสมดำ,บางกระดี่ หมู่ 8,ชุมชนเมือง,426,234,192
1021,บางขุนเทียน,แสมดำ,บางกระดี่ หมู่ 9,ชุมชนเมือง,845,442,403
1021,บางขุนเทียน,แสมดำ,เพชรทองคำ,ชุมชนเมือง,5449,2923,2526
1021,บางขุนเทียน,แสมดำ,วัดกำแพง,ชุมชนเมือง,724,319,405
1021,บางขุนเทียน,แสมดำ,วัดสะแกงาม,ชุมชนเมือง,1890,850,1040
1021,บางขุนเทียน,แสมดำ,วัดแสมดำ,ชุมชนเมือง,453,220,233
1021,บางขุนเทียน,แสมดำ,สายสัมพันธ์ หมู่ 7,ชุมชนเมือง,438,160,278
1021,บางขุนเทียน,แสมดำ,สามัคคี หมู่ 1,ชุมชนเมือง,794,458,336
1021,บางขุนเทียน,แสมดำ,หมู่บ้านเกาะโพธิ์ หมู่ 10,ชุมชนชานเมือง,900,445,455
1021,บางขุนเทียน,แสมดำ,ซอยดอกรัก หมู่ 1,ชุมชนเมือง,1093,551,542
1021,บางขุนเทียน,แสมดำ,วัดนาคสี่บาท หมู่ 7,ชุมชนแออัด,750,392,358
1021,บางขุนเทียน,แสมดำ,เคหะธนบุรี 1 ส่วน 1 หมู่ 6,ชุมชนเมือง,2188,976,1212
1021,บางขุนเทียน,แสมดำ,เชื่อมสัมพันธ์ หมู่ 4,ชุมชนเมือง,688,288,400
1021,บางขุนเทียน,แสมดำ,เคหะธนบุรี 1 ส่วน 2,ชุมชนเมือง,4300,1800,2500
1021,บางขุนเทียน,แสมดำ,ซอยศักดิ์มงคลชัย,ชุมชนเมือง,870,395,475
1021,บางขุนเทียน,แสมดำ,เคหะธนบุรี 1 ส่วน 3,ชุมชนเมือง,2780,1290,1490
1021,บางขุนเทียน,แสมดำ,เคหะธนบุรี 3 โซน 1,ชุมชนเมือง,2810,950,1860
1021,บางขุนเทียน,แสมดำ,เคหะธนบุรี 3 โซน 2,ชุมชนเมือง,1269,458,811
1021,บางขุนเทียน,แสมดำ,ข้างสถานีวิทยุเพื่อการศึกษา,ชุมชนเมือง,496,241,255
1021,บางขุนเทียน,แสมดำ,ปู่โฉมพัฒนา,ชุมชนแออัด,503,240,263
1021,บางขุนเทียน,แสมดำ,มุ่งพัฒนา,ชุมชนเมือง,1486,646,840
1021,บางขุนเทียน,แสมดำ,หมู่บ้านสวัสดี,ชุมชนเมือง,479,210,269
1021,บางขุนเทียน,แสมดำ,โฟร์โมสต์,ชุมชนเมือง,1372,675,697
1021,บางขุนเทียน,แสมดำ,เคหะธนบุรี 1 ส่วน 5 โซน 1,ชุมชนเมือง,1380,638,742
1021,บางขุนเทียน,แสมดำ,เคหะธนบุรี 1 ส่วน 5 โซน 2,ชุมชนเมือง,1382,609,773
1021,บางขุนเทียน,แสมดำ,เคหะธนบุรี 1 ส่วน 4,ชุมชนเมือง,1284,578,706
1005,บางเขน,อนุสาวรีย์,ซอยอุ่นจิตร,ชุมชนเมือง,399,190,209
1005,บางเขน,อนุสาวรีย์,ทิมเรืองเวช,ชุมชนเมือง,927,458,469
1005,บางเขน,อนุสาวรีย์,ชมรมหมู่บ้านพหลโยธิน 48,ชุมชนเมือง,1235,539,696
1005,บางเขน,อนุสาวรีย์,ร่วมพัฒนา 33,ชุมชนเมือง,1846,869,977
1005,บางเขน,อนุสาวรีย์,สุขสันต์พัฒนา,ชุมชนเมือง,1592,725,867
1005,บางเขน,อนุสาวรีย์,หมู่บ้านเฉลิมสุขนิเวศน์,ชุมชนเมือง,1005,469,536
1005,บางเขน,อนุสาวรีย์,หมู่บ้านซอยน้ำใส,ชุมชนเมือง,632,296,336
1005,บางเขน,อนุสาวรีย์,หมู่บ้านไปรษณีย์นิเวศน์,ชุมชนเมือง,639,283,356
1005,บางเขน,อนุสาวรีย์,หมู่บ้านฝนทองนิเวศน์,ชุมชนเมือง,1515,431,1084
1005,บางเขน,อนุสาวรีย์,หมู่บ้านรุ่งสว่างวิลเลจ,ชุมชนเมือง,907,433,474
1005,บางเขน,อนุสาวรีย์,หมู่บ้านสดใส,ชุมชนเมือง,782,329,453
1005,บางเขน,อนุสาวรีย์,หมู่บ้านอนันต์สุขสันต์,ชุมชนเมือง,734,331,403
1005,บางเขน,อนุสาวรีย์,หมู่บ้านอยู่เจริญ,ชุมชนเมือง,716,317,399
1005,บางเขน,อนุสาวรีย์,วัดไตรรัตนาราม,ชุมชนเมือง,2513,1206,1307
1005,บางเขน,อนุสาวรีย์,หมู่บ้านปั้นทอง 3,ชุมชนเมือง,1715,754,961
1005,บางเขน,อนุสาวรีย์,บางบัว,ชุมชนเมือง,836,394,442
1005,บางเขน,อนุสาวรีย์,ร่วมใจพัฒนา (เหนือ),ชุมชนแออัด,655,279,376
1005,บางเขน,อนุสาวรีย์,ร้อยกรอง,ชุมชนแออัด,730,375,355
1005,บางเขน,อนุสาวรีย์,รุ่นใหม่พัฒนา,ชุมชนเมือง,2000,700,1300
1005,บางเขน,อนุสาวรีย์,สามัคคีร่วมใจ,ชุมชนเมือง,550,262,288
1005,บางเขน,อนุสาวรีย์,ยิ่งศิริ,ชุมชนเมือง,436,167,269
1005,บางเขน,อนุสาวรีย์,หมู่บ้านเอี่ยมพานิช,ชุมชนเมือง,1447,657,790
1005,บางเขน,อนุสาวรีย์,อุทิศอนุสรณ์,ชุมชนเมือง,374,169,205
1005,บางเขน,อนุสาวรีย์,หมู่บ้านสินทรัพย์นคร,ชุมชนเมือง,2184,1004,1180
1005,บางเขน,อนุสาวรีย์,ร่วมใจพัฒนาใต้,ชุมชนแออัด,761,360,401
1005,บางเขน,อนุสาวรีย์,พลังสามัคคี,ชุมชนเมือง,484,201,283
1005,บางเขน,อนุสาวรีย์,กองพันทหารช่างที่ 1 รักษาพระองค์,ชุมชนเมือง,706,371,335
1005,บางเขน,อนุสาวรีย์,หมู่บ้านพร้อมสุข,ชุมชนเมือง,575,227,348
1005,บางเขน,อนุสาวรีย์,สื่อสารรวมใจสามัคคี,ชุมชนอาคารสูง,393,211,182
1005,บางเขน,อนุสาวรีย์,ทหารผ่านศึก,ชุมชนเมือง,504,254,250
1005,บางเขน,อนุสาวรีย์,อยู่รวย,ชุมชนเมือง,886,388,498
1005,บางเขน,อนุสาวรีย์,ร่วมใจพัฒนากลาง,ชุมชนแออัด,249,119,130
1005,บางเขน,อนุสาวรีย์,โสรัจ,ชุมชนเมือง,431,196,235
1005,บางเขน,อนุสาวรีย์,หมู่บ้านเธียรสวน,ชุมชนเมือง,1166,484,682
1005,บางเขน,อนุสาวรีย์,กูบแดงร่วมใจพัฒนา,ชุมชนเมือง,441,351,90
1005,บางเขน,อนุสาวรีย์,อาคารสงเคราะห์ ทบ. (ส่วนกลาง),ชุมชนอาคารสูง,3300,1630,1670
1005,บางเขน,อนุสาวรีย์,อาคารสวัสดิการ นทพ.,ชุมชนอาคารสูง,603,322,281
1005,บางเขน,อนุสาวรีย์,กรมทหารขนส่งรักษาพระองค์,ชุมชนอาคารสูง,1434,730,704
1005,บางเขน,อนุสาวรีย์,หมู่บ้านสวนทองวิลล่า 1,ชุมชนเมือง,315,152,163
1005,บางเขน,อนุสาวรีย์,แฟลต สน.บางเขน,ชุมชนอาคารสูง,230,127,103
1005,บางเขน,อนุสาวรีย์,กองซ่อมเครื่องสื่อสาร-อิเล็คทรอนิคส์,ชุมชนอาคารสูง,198,122,76
1005,บางเขน,อนุสาวรีย์,หมู่บ้านวังไผ่,ชุมชนเมือง,349,149,200
1005,บางเขน,อนุสาวรีย์,กองการภาพ,ชุมชนอาคารสูง,759,499,260
1005,บางเขน,อนุสาวรีย์,ซอยเสือเอก 1-2,ชุมชนเมือง,540,232,308
1005,บางเขน,อนุสาวรีย์,ซอยแจ้งวัฒนะ 4,ชุมชนเมือง,625,305,320
1005,บางเขน,อนุสาวรีย์,สร.สัมพันธ์,ชุมชนเมือง,217,112,105
1005,บางเขน,ท่าแร้ง,สุขสันติ,ชุมชนเมือง,393,176,217
1005,บางเขน,ท่าแร้ง,หมู่บ้านคงหิรัญ,ชุมชนเมือง,352,166,186
1005,บางเขน,ท่าแร้ง,หมู่บ้านเฉลิมสุข 9,ชุมชนเมือง,606,273,333
1005,บางเขน,ท่าแร้ง,หมู่บ้านในฝัน (เคหะธานี),ชุมชนเมือง,371,228,143
1005,บางเขน,ท่าแร้ง,หมู่บ้านไปรษณีย์,ชุมชนเมือง,1643,786,857
1005,บางเขน,ท่าแร้ง,หมู่บ้านพัฒนาคลองหลุมไผ่,ชุมชนเมือง,693,324,369
1005,บางเขน,ท่าแร้ง,หมู่บ้านอยู่เย็นเป็นสุข,ชุมชนเมือง,728,318,410
1005,บางเขน,ท่าแร้ง,เคหะรามอินทรา,ชุมชนอาคารสูง,1986,1114,872
1005,บางเขน,ท่าแร้ง,เพชรสยาม,ชุมชนเมือง,593,294,299
1005,บางเขน,ท่าแร้ง,หมู่บ้านอนันต์สุขสันต์ รุ่น 18-20,ชุมชนเมือง,4510,2145,2365
1005,บางเขน,ท่าแร้ง,วัดอาวุธ,ชุมชนแออัด,856,401,455
1005,บางเขน,ท่าแร้ง,หมู่บ้านสุขใจวิลเลจ,ชุมชนเมือง,500,206,294
1005,บางเขน,ท่าแร้ง,หมู่บ้านแหลมทองพัฒนา,ชุมชนเมือง,248,113,135
1005,บางเขน,ท่าแร้ง,หมู่บ้านศิริชัย,ชุมชนเมือง,261,120,141
1005,บางเขน,ท่าแร้ง,หมู่บ้านเก้าแสน 2,ชุมชนเมือง,733,353,380
1005,บางเขน,ท่าแร้ง,สุขฤดี,ชุมชนเมือง,981,453,528
1005,บางเขน,ท่าแร้ง,วัชรปราณี,ชุมชนแออัด,1054,447,607
1005,บางเขน,ท่าแร้ง,หมู่บ้านเสนาวิลล่า,ชุมชนเมือง,1799,818,981
1005,บางเขน,ท่าแร้ง,หมู่บ้านบางเขนวิลล่า,ชุมชนเมือง,427,190,237
1005,บางเขน,ท่าแร้ง,ลำชะล่า (โคกบ่าวสาว),ชุมชนแออัด,932,406,526
1005,บางเขน,ท่าแร้ง,หมู่บ้านรามอินทรา 67,ชุมชนเมือง,886,435,451
1005,บางเขน,ท่าแร้ง,หมู่บ้านพัชรัฐ,ชุมชนเมือง,1340,625,715
1005,บางเขน,ท่าแร้ง,เกษตรก้าวหน้าลำรางหนองกง,ชุมชนชานเมือง,466,206,260
1005,บางเขน,ท่าแร้ง,เกษตรพัฒนาบึงพระยาสุเรนทร์,ชุมชนชานเมือง,466,206,260
1005,บางเขน,ท่าแร้ง,หมู่บ้านธันธวัช 5,ชุมชนเมือง,563,235,328
1005,บางเขน,ท่าแร้ง,หมู่บ้านเจษฎาวรรณ 2,ชุมชนเมือง,498,210,288
1005,บางเขน,ท่าแร้ง,หมู่บ้านพุดซ้อน,ชุมชนเมือง,475,201,274
1031,บางคอแหลม,บางคอแหลม,เชิงสะพานกรุงเทพ,ชุมชนแออัด,440,213,227
1031,บางคอแหลม,บางคอแหลม,ซอยวัดอินทร์บรรจง,ชุมชนแออัด,974,388,586
1031,บางคอแหลม,บางคอแหลม,เซ่งกี่,ชุมชนแออัด,732,359,373
1031,บางคอแหลม,บางคอแหลม,บางคอแหลม,ชุมชนแออัด,3090,1402,1688
1031,บางคอแหลม,บางคอแหลม,มาตานุสรณ์,ชุมชนแออัด,868,386,482
1031,บางคอแหลม,บางคอแหลม,วัดจันทร์ใน,ชุมชนแออัด,3703,1296,2407
1031,บางคอแหลม,บางคอแหลม,วัดลาดบัวขาว,ชุมชนแออัด,380,181,199
1031,บางคอแหลม,บางคอแหลม,สวนหลวง 1,ชุมชนแออัด,2640,1108,1532
1031,บางคอแหลม,บางคอแหลม,หลังโรงพยาบาลเจริญกรุงประชารักษ์,ชุมชนแออัด,1060,547,513
1031,บางคอแหลม,บางคอแหลม,อาคารสงเคราะห์ฯ บางคอแหลม,ชุมชนอาคารสูง,432,214,218
1031,บางคอแหลม,วัดพระยาไกร,ซอยเจริญกรุง 89,ชุมชนแออัด,700,320,380
1031,บางคอแหลม,วัดพระยาไกร,ซอยโรงเจ,ชุมชนแออัด,1043,465,578
1031,บางคอแหลม,วัดพระยาไกร,บางอุทิศ,ชุมชนแออัด,3000,1200,1800
1031,บางคอแหลม,วัดพระยาไกร,วัดพระยาไกรระยะ 3,ชุมชนแออัด,3869,1567,2302
1031,บางคอแหลม,วัดพระยาไกร,สวนหลวง 2 / วัดราชสิงขร,ชุมชนแออัด,2555,1094,1461
1031,บางคอแหลม,วัดพระยาไกร,หลังตลาดเก่าวัดพระยาไกร,ชุมชนแออัด,810,400,410
1031,บางคอแหลม,วัดพระยาไกร,ศาลเจ้าแดง,ชุมชนแออัด,518,182,336
1031,บางคอแหลม,วัดพระยาไกร,ร่วมใจพัฒนา,ชุมชนแออัด,1923,965,958
1031,บางคอแหลม,วัดพระยาไกร,หลังสามร้อยห้อง,ชุมชนแออัด,881,375,506
1031,บางคอแหลม,วัดพระยาไกร,บาหยัน,ชุมชนแออัด,501,230,271
1031,บางคอแหลม,วัดพระยาไกร,มิตรสัมพันธ์,ชุมชนแออัด,465,214,251
1031,บางคอแหลม,บางโคล่,ซอยบุญประทานพร,ชุมชนแออัด,522,253,269
1031,บางคอแหลม,บางโคล่,บางโคล่,ชุมชนแออัด,473,126,347
1031,บางคอแหลม,บางโคล่,โรงแก้ว,ชุมชนแออัด,468,218,250
1031,บางคอแหลม,บางโคล่,วัดไผ่เงิน,ชุมชนแออัด,2585,1250,1335
1031,บางคอแหลม,บางโคล่,ห้องเย็น,ชุมชนแออัด,267,137,130
1031,บางคอแหลม,บางโคล่,เมืองอยู่ดี,ชุมชนเมือง,2480,1154,1326
1031,บางคอแหลม,บางโคล่,ศาลเจ้าแม่ตะเคียนทอง,ชุมชนแออัด,769,357,412
1040,บางแค,บางแค,กระถินทอง,ชุมชนแออัด,220,90,130
1040,บางแค,บางแค,คลองยายเทียบฝั่งใต้,ชุมชนแออัด,712,385,327
1040,บางแค,บางแค,งามปัญจะ,ชุมชนแออัด,450,200,250
1040,บางแค,บางแค,ซอยพึ่งธรรม,ชุมชนแออัด,260,132,128
1040,บางแค,บางแค,นิมมานรดี,ชุมชนแออัด,761,324,437
1040,บางแค,บางแค,เพิ่มทรัพย์,ชุมชนแออัด,500,200,300
1040,บางแค,บางแค,ยิ้มประยูร,ชุมชนแออัด,437,163,274
1040,บางแค,บางแค,หมู่บ้านชัยมงคล,ชุมชนแออัด,1260,605,655
1040,บางแค,บางแค,หลังโรงเรียนสากลศึกษา,ชุมชนเมือง,280,94,186
1040,บางแค,บางแคเหนือ,เลียบคลองทวีวัฒนา,ชุมชนแออัด,700,305,395
1040,บางแค,บางแคเหนือ,คลองยายเทียบฝั่งเหนือ,ชุมชนแออัด,201,85,116
1040,บางแค,บางแคเหนือ,ริมคลองราชมนตรี,ชุมชนแออัด,1560,765,795
1040,บางแค,บางแคเหนือ,โรงเรียนราชวินิตประถมบางแค,ชุมชนแออัด,672,311,361
1040,บางแค,บางแคเหนือ,นครแสงเพชร,ชุมชนแออัด,500,243,257
1040,บางแค,บางแคเหนือ,พุ่มพวง,ชุมชนแออัด,532,256,276
1040,บางแค,บางแคเหนือ,หมู่บ้านชมเดือน,ชุมชนเมือง,800,363,437
1040,บางแค,บางแคเหนือ,หมู่บ้านพุทธมณฑล,ชุมชนเมือง,551,245,306
1040,บางแค,บางแคเหนือ,รวมใจริมคลอง หมู่ 3,ชุมชนแออัด,1300,505,795
1040,บางแค,บางแคเหนือ,ฤทธิ์พัฒนา,ชุมชนเมือง,281,81,200
1040,บางแค,บางแคเหนือ,เศรษฐกิจร่วมใจพัฒนา,ชุมชนเมือง,631,306,325
1040,บางแค,บางแคเหนือ,จั่นแก้ว,ชุมชนเมือง,384,176,208
1040,บางแค,บางแคเหนือ,เทวินรวมใจ,ชุมชนเมือง,450,150,300
1040,บางแค,บางไผ่,วัดพรหมสุวรรณสามัคคี,ชุมชนชานเมือง,2700,1480,1220
1040,บางแค,บางไผ่,ข้างโรงพยาบาลราชพิพัฒน์,ชุมชนชานเมือง,826,423,403
1040,บางแค,บางไผ่,เจริญแพทย์,ชุมชนแออัด,550,255,295
1040,บางแค,บางไผ่,ทองพูนพัฒนา,ชุมชนชานเมือง,2510,1200,1310
1040,บางแค,บางไผ่,นครลุง,ชุมชนชานเมือง,1258,533,725
1040,บางแค,บางไผ่,ศิริเกษม 1,ชุมชนเมือง,560,250,310
1040,บางแค,บางไผ่,ศิริเกษมพัฒนา,ชุมชนเมือง,2081,970,1111
1040,บางแค,บางไผ่,รักษ์พัฒนา,ชุมชนชานเมือง,1538,697,841
1040,บางแค,บางไผ่,ศิริเกษมรวมใจ 50,ชุมชนเมือง,1824,812,1012
1040,บางแค,บางไผ่,สามัคคีศิริเกษม 2,ชุมชนเมือง,682,320,362
1040,บางแค,บางไผ่,อัสสัมชัญพัฒนา,ชุมชนเมือง,397,182,215
1040,บางแค,บางไผ่,หลังวัดบุณยประดิษฐ์,ชุมชนชานเมือง,0,0,0
1040,บางแค,หลักสอง,ซอยเจิมจิตต์,ชุมชนแออัด,300,105,195
1040,บางแค,หลักสอง,ชาววัดม่วง,ชุมชนแออัด,330,115,215
1040,บางแค,หลักสอง,ร่วมใจพัฒนา,ชุมชนแออัด,620,420,200
1040,บางแค,หลักสอง,เลียบคลองบางแค,ชุมชนแออัด,368,164,204
1040,บางแค,หลักสอง,เทพพิทักษ์,ชุมชนเมือง,295,130,165
1040,บางแค,หลักสอง,ปู่เย็น ย่าคำ ยังอยู่,ชุมชนแออัด,1050,475,575
1040,บางแค,หลักสอง,บ้านขิง,ชุมชนเมือง,1446,482,964
1040,บางแค,หลักสอง,สุขสำราญ,ชุมชนเมือง,152,73,79
1040,บางแค,หลักสอง,มีสุวรรณพัฒนา,ชุมชนแออัด,618,293,325
1040,บางแค,หลักสอง,หมู่บ้านเพชรสยาม 3,ชุมชนเมือง,1305,436,869
1040,บางแค,หลักสอง,ร่มเย็น,ชุมชนเมือง,2572,1273,1299
1040,บางแค,หลักสอง,ศาลพ่อปู่ดำ,ชุมชนเมือง,623,286,337
1040,บางแค,หลักสอง,เกษตรรุ่งเรือง,ชุมชนแออัด,490,124,366
1040,บางแค,หลักสอง,ซอยเรืองสอน 1,ชุมชนเมือง,450,202,248
1029,บางซื่อ,บางซื่อ,หัวรถจักรตึกแดง เขต 2,ชุมชนแออัด,990,400,590
1029,บางซื่อ,บางซื่อ,เขมาเนรมิตร,ชุมชนแออัด,1100,562,538
1029,บางซื่อ,บางซื่อ,จันทร์เกษม,ชุมชนแออัด,806,368,438
1029,บางซื่อ,บางซื่อ,เชิงสะพานพิบูลสงครามฝั่งซ้าย,ชุมชนแออัด,310,148,162
1029,บางซื่อ,บางซื่อ,ซอยเดรี่เบลล์,ชุมชนแออัด,395,216,179
1029,บางซื่อ,บางซื่อ,ซอยประดู่,ชุมชนแออัด,542,299,243
1029,บางซื่อ,บางซื่อ,ซอยพัฒนา,ชุมชนแออัด,410,192,218
1029,บางซื่อ,บางซื่อ,ซอยสนิท,ชุมชนแออัด,400,157,243
1029,บางซื่อ,บางซื่อ,ซอยสีน้ำเงิน 1,ชุมชนแออัด,1250,568,682
1029,บางซื่อ,บางซื่อ,ซอยสีน้ำเงิน 2,ชุมชนแออัด,527,239,288
1029,บางซื่อ,บางซื่อ,ตรอกต้นมะม่วง,ชุมชนแออัด,547,245,302
1029,บางซื่อ,บางซื่อ,ตรอกตรงข้ามวัดสะพานสูง,ชุมชนแออัด,405,205,200
1029,บางซื่อ,บางซื่อ,บ้านพักรถไฟก่อสร้าง,ชุมชนแออัด,1950,950,1000
1029,บางซื่อ,บางซื่อ,บุญเหลือ เขต 1,ชุมชนแออัด,1413,591,822
1029,บางซื่อ,บางซื่อ,บุญเหลือเขต 2,ชุมชนแออัด,365,170,195
1029,บางซื่อ,บางซื่อ,วัดเชิงหวาย,ชุมชนแออัด,1814,824,990
1029,บางซื่อ,บางซื่อ,วัดบางโพโอมาวาส,ชุมชนแออัด,241,114,127
1029,บางซื่อ,บางซื่อ,วัดประดู่ธรรมาธิปัตย์,ชุมชนแออัด,619,266,353
1029,บางซื่อ,บางซื่อ,วัดสร้อยทอง,ชุมชนแออัด,1501,684,817
1029,บางซื่อ,บางซื่อ,ศรีบุญยืน,ชุมชนแออัด,480,212,268
1029,บางซื่อ,บางซื่อ,สวัสดิรักษา,ชุมชนแออัด,588,230,358
1029,บางซื่อ,บางซื่อ,สะพานไม้,ชุมชนแออัด,455,185,270
1029,บางซื่อ,บางซื่อ,สุขสันต์ 1,ชุมชนแออัด,601,342,259
1029,บางซื่อ,บางซื่อ,สุขสันต์ 2,ชุมชนแออัด,1615,976,639
1029,บางซื่อ,บางซื่อ,หลังตลาดบางซื่อ,ชุมชนแออัด,360,120,240
1029,บางซื่อ,บางซื่อ,หลังตลาดศรีเขมา,ชุมชนแออัด,1329,579,750
1029,บางซื่อ,บางซื่อ,หัวรถจักรตึกแดง เขต 1,ชุมชนแออัด,1345,610,735
1029,บางซื่อ,บางซื่อ,หัวรถจักรตึกแดง เขต 3,ชุมชนแออัด,1110,450,660
1029,บางซื่อ,บางซื่อ,ซอยโชติวัฒน์,ชุมชนแออัด,306,146,160
1029,บางซื่อ,บางซื่อ,ซอยโจ๊ก,ชุมชนแออัด,545,323,222
1029,บางซื่อ,บางซื่อ,หมู่บ้านเขมาเนรมิตรนิเวศน์,ชุมชนเมือง,914,454,460
1029,บางซื่อ,บางซื่อ,ศรีบุญยืนพัฒนา,ชุมชนแออัด,541,239,302
1029,บางซื่อ,บางซื่อ,ประชานฤมิตร,ชุมชนเมือง,1808,723,1085
1029,บางซื่อ,บางซื่อ,พัฒนาประชาราษฎร์ 30,ชุมชนแออัด,700,365,335
1029,บางซื่อ,บางซื่อ,ราชทรัพย์,ชุมชนแออัด,786,388,398
1029,บางซื่อ,บางซื่อ,ปทุมทิพย์,ชุมชนแออัด,450,220,230
1029,บางซื่อ,บางซื่อ,สุดซอยสีน้ำเงิน,ชุมชนแออัด,340,147,193
1029,บางซื่อ,บางซื่อ,แฟลตตำรวจรถไฟบางซื่อ,ชุมชนอาคารสูง,250,140,110
1029,บางซื่อ,วงศ์สว่าง,ข้างวัดมัชฌันติการาม,ชุมชนแออัด,466,190,276
1029,บางซื่อ,วงศ์สว่าง,ซอยวัดหลวง,ชุมชนแออัด,1600,748,852
1029,บางซื่อ,วงศ์สว่าง,ซอยสวนรื่น,ชุมชนแออัด,450,220,230
1029,บางซื่อ,วงศ์สว่าง,ปานทิพย์ 1,ชุมชนแออัด,689,379,310
1029,บางซื่อ,วงศ์สว่าง,ยิ้มประยูรพัฒนา,ชุมชนแออัด,779,361,418
1029,บางซื่อ,วงศ์สว่าง,วัดเลียบ,ชุมชนแออัด,1470,691,779
1029,บางซื่อ,วงศ์สว่าง,วัดเสาหิน,ชุมชนแออัด,267,121,146
1029,บางซื่อ,วงศ์สว่าง,สมบุญดี,ชุมชนแออัด,800,370,430
1029,บางซื่อ,วงศ์สว่าง,สุดซอยสมถวิล,ชุมชนแออัด,213,96,117
1029,บางซื่อ,วงศ์สว่าง,บ้านสามเรือน,ชุมชนแออัด,146,72,74
1029,บางซื่อ,วงศ์สว่าง,ข้างธนาคารอาคารสงเคราะห์,ชุมชนแออัด,222,108,114
1029,บางซื่อ,วงศ์สว่าง,หลังเทคโนโลยีพระจอมเกล้าพระนครเหนือ,ชุมชนแออัด,460,207,253
1047,บางนา,บางนาเหนือ,รุ่งเรือง,ชุมชนแออัด,760,378,382
1047,บางนา,บางนาเหนือ,บัวเกิด,ชุมชนเมือง,3224,1582,1642
1047,บางนา,บางนาเหนือ,พูนสิน,ชุมชนเมือง,702,338,364
1047,บางนา,บางนาเหนือ,หมู่บ้านจัดสรรยาสูบ,ชุมชนเมือง,2945,1462,1483
1047,บางนา,บางนาเหนือ,หมู่บ้านมณียาวิวล์,ชุมชนเมือง,2318,1112,1206
1047,บางนา,บางนาเหนือ,บ้านพักองค์การแบตเตอรี่,ชุมชนเมือง,101,49,52
1047,บางนา,บางนาเหนือ,กุศลศิลป์,ชุมชนเมือง,1557,568,989
1047,บางนา,บางนาเหนือ,พึ่งทรัพย์,ชุมชนเมือง,1948,844,1104
1047,บางนา,บางนาเหนือ,หมู่บ้านซอยเชลียง 1,ชุมชนเมือง,7950,3185,4765
1047,บางนา,บางนาเหนือ,หมู่บ้านแสนสุข,ชุมชนเมือง,1204,598,606
1047,บางนา,บางนาเหนือ,หมู่บ้านไพโรจน์,ชุมชนเมือง,3810,1828,1982
1047,บางนา,บางนาเหนือ,มหาสิน,ชุมชนเมือง,3256,1589,1667
1047,บางนา,บางนาเหนือ,สยามคอนโด 2,ชุมชนอาคารสูง,220,112,108
1047,บางนา,บางนาใต้,กลางนา,ชุมชนแออัด,860,408,452
1047,บางนา,บางนาใต้,ซอยโปษยานนท์,ชุมชนแออัด,400,125,275
1047,บางนา,บางนาใต้,ทองใบ,ชุมชนเมือง,651,430,221
1047,บางนา,บางนาใต้,พูนสวัสดิ์,ชุมชนเมือง,472,232,240
1047,บางนา,บางนาใต้,ร่วมใจประเสริฐ,ชุมชนเมือง,460,202,258
1047,บางนา,บางนาใต้,ร่วมพัฒนา,ชุมชนเมือง,420,196,224
1047,บางนา,บางนาใต้,รุ่งสว่าง,ชุมชนเมือง,300,120,180
1047,บางนา,บางนาใต้,วงศ์สวัสดิ์,ชุมชนเมือง,397,303,94
1047,บางนา,บางนาใต้,วัดบางนานอก,ชุมชนแออัด,458,227,231
1047,บางนา,บางนาใต้,วัดผ่องพลอยอนุสรณ์ (ลิขิต 2),ชุมชนเมือง,1901,1056,845
1047,บางนา,บางนาใต้,หมู่บ้านศานติ,ชุมชนเมือง,493,294,199
1047,บางนา,บางนาใต้,คลองบางนา,ชุมชนชานเมือง,264,112,152
1047,บางนา,บางนาใต้,บ้านเรวัตินิเวศน์ 2,ชุมชนเมือง,1125,565,560
1047,บางนา,บางนาใต้,หมู่บ้านทิมเรืองเวช,ชุมชนเมือง,694,251,443
1047,บางนา,บางนาใต้,เจริญรุ่งเรือง,ชุมชนแออัด,524,265,259
1047,บางนา,บางนาใต้,ร่มประดู่,ชุมชนเมือง,1019,505,514
1047,บางนา,บางนาใต้,นิติบุคคลอาคารชุด เคหะชุมชนบางนา 2,ชุมชนอาคารสูง,1103,514,589
1047,บางนา,บางนาใต้,พึ่งบุญ,ชุมชนเมือง,310,148,162
1050,บางบอน,บางบอนเหนือ,การเกษตรบ้านนายผล,ชุมชนชานเมือง,393,187,206
1050,บางบอน,บางบอนเหนือ,หมู่บ้านรางไผ่,ชุมชนเมือง,596,264,332
1050,บางบอน,บางบอนเหนือ,หมู่บ้านกานดาคลาสสิควิลล์,ชุมชนเมือง,863,397,466
1050,บางบอน,บางบอนเหนือ,บ้านมั่นคงวิมานทอง,ชุมชนเมือง,453,222,231
1050,บางบอน,บางบอนใต้,วัดบางบอน,ชุมชนชานเมือง,163,77,86
1050,บางบอน,บางบอนใต้,สถานีรางโพธิ์,ชุมชนชานเมือง,479,239,240
1050,บางบอน,บางบอนใต้,มั่นคง 133,ชุมชนเมือง,307,126,181
1050,บางบอน,คลองบางพราน,ซอยกำนันแม้น 13,ชุมชนเมือง,1111,503,608
1050,บางบอน,คลองบางพราน,ริมคลองพระยาราชมนตรี หมู่ 9,ชุมชนแออัด,366,169,197
1050,บางบอน,คลองบางพราน,สวนผักหมู่ 8,ชุมชนเมือง,380,193,187
1050,บางบอน,คลองบางพราน,หนทางใหม่ปิ่นทอง,ชุมชนเมือง,837,377,460
1050,บางบอน,คลองบางพราน,คลองบางพรานพัฒนา,ชุมชนแออัด,167,87,80
1025,บางพลัด,บางพลัด,คลองสวนพริก,ชุมชนแออัด,1326,575,751
1025,บางพลัด,บางพลัด,พัฒนาซอย 79,ชุมชนแออัด,804,392,412
1025,บางพลัด,บางพลัด,วัดเทพากร,ชุมชนแออัด,903,555,348
1025,บางพลัด,บางพลัด,สะพานยาว,ชุมชนแออัด,138,63,75
1025,บางพลัด,บางพลัด,วัดเทพนารี,ชุมชนแออัด,979,420,559
1025,บางพลัด,บางพลัด,จรัญฯ 72,ชุมชนแออัด,866,406,460
1025,บางพลัด,บางพลัด,วัดบางพลัด,ชุมชนแออัด,356,161,195
1025,บางพลัด,บางพลัด,ดวงดี,ชุมชนแออัด,580,280,300
1025,บางพลัด,บางพลัด,วัดภาณุรังษี,ชุมชนแออัด,583,331,252
1025,บางพลัด,บางพลัด,สวนปรก,ชุมชนแออัด,135,60,75
1025,บางพลัด,บางพลัด,เจ้าพระยาสยาม,ชุมชนเมือง,495,236,259
1025,บางพลัด,บางพลัด,วัดเพลง,ชุมชนแออัด,162,75,87
1025,บางพลัด,บางพลัด,จรัญฯ 66/1,ชุมชนเมือง,617,275,342
1025,บางพลัด,บางพลัด,ศาลเจ้าปุงเท่ากง,ชุมชนเมือง,501,230,271
1025,บางพลัด,บางอ้อ,จรัญวิถี 74,ชุมชนแออัด,196,70,126
1025,บางพลัด,บางอ้อ,พัฒนาซอย 85,ชุมชนแออัด,1779,817,962
1025,บางพลัด,บางอ้อ,วัดฉัตรแก้วจงกลณี,ชุมชนแออัด,339,108,231
1025,บางพลัด,บางอ้อ,วัดวิมุตยาราม,ชุมชนแออัด,480,203,277
1025,บางพลัด,บางอ้อ,สงวนทรัพย์,ชุมชนแออัด,483,224,259
1025,บางพลัด,บางอ้อ,มัสยิดบางอ้อ - จรัญฯ 86,ชุมชนแออัด,1325,735,590
1025,บางพลัด,บางอ้อ,ริมคลองบางพลัด,ชุมชนแออัด,386,163,223
1025,บางพลัด,บางอ้อ,คลองบางพระครู,ชุมชนแออัด,1028,498,530
1025,บางพลัด,บางอ้อ,คลองมะนาว,ชุมชนแออัด,386,163,223
1025,บางพลัด,บางอ้อ,ชินศรี 91,ชุมชนแออัด,267,125,142
1025,บางพลัด,บางอ้อ,แสงทอง,ชุมชนแออัด,1546,715,831
1025,บางพลัด,บางอ้อ,ร่วมใจสามัคคี,ชุมชนแออัด,1202,527,675
1025,บางพลัด,บางอ้อ,เติมสุข,ชุมชนแออัด,443,212,231
1025,บางพลัด,บางอ้อ,อยู่ดีร่วมใจพัฒนา,ชุมชนเมือง,709,331,378
1025,บางพลัด,บางอ้อ,บ้านมั่นคงฟ้าใหม่,ชุมชนเมือง,299,141,158
1025,บางพลัด,บางบำหรุ,โค้งมะขาม,ชุมชนแออัด,1815,702,1113
1025,บางพลัด,บางบำหรุ,บ้านญวน,ชุมชนแออัด,1200,525,675
1025,บางพลัด,บางบำหรุ,มะพร้าวคู่,ชุมชนแออัด,780,313,467
1025,บางพลัด,บางบำหรุ,วัดรวกบางบำหรุ,ชุมชนแออัด,1891,957,934
1025,บางพลัด,บางบำหรุ,คลองบางบำหรุ,ชุมชนแออัด,829,352,477
1025,บางพลัด,บางบำหรุ,ร่วมพัฒนาซอยจรัญฯ 65,ชุมชนเมือง,1372,609,763
1025,บางพลัด,บางยี่ขัน,บ้านปูน,ชุมชนแออัด,1228,538,690
1025,บางพลัด,บางยี่ขัน,วัดดาวดึงษาราม,ชุมชนแออัด,880,385,495
1025,บางพลัด,บางยี่ขัน,วัดภคินีนาถ,ชุมชนแออัด,1230,536,694
1025,บางพลัด,บางยี่ขัน,วัดบวรมงคล,ชุมชนแออัด,3312,1452,1860
1025,บางพลัด,บางยี่ขัน,วัดพระยาศิริไอยสวรรค์,ชุมชนแออัด,1105,442,663
1025,บางพลัด,บางยี่ขัน,คลองเจ้าครุฑ,ชุมชนแออัด,346,198,148
1025,บางพลัด,บางยี่ขัน,วัดสิงห์,ชุมชนแออัด,632,337,295
1025,บางพลัด,บางยี่ขัน,โค้งถ่าน,ชุมชนแออัด,306,142,164
1025,บางพลัด,บางยี่ขัน,ศรีอุลัย,ชุมชนแออัด,1882,844,1038
1025,บางพลัด,บางยี่ขัน,วัดคฤหบดี,ชุมชนแออัด,2496,1213,1283
1025,บางพลัด,บางยี่ขัน,สะพานไม้,ชุมชนแออัด,942,412,530
1025,บางพลัด,บางยี่ขัน,วัดทอง,ชุมชนแออัด,698,275,423
1025,บางพลัด,บางยี่ขัน,ซอยรถไฟวรพงษ์,ชุมชนเมือง,613,271,342
1004,บางรัก,มหาพฤฒาราม,ซอยวัดมหาพฤฒาราม (ชุมชนซอยแก้วฟ้า),ชุมชนเมือง,225,99,126
1004,บางรัก,มหาพฤฒาราม,ซอยสองพระ,ชุมชนเมือง,768,371,397
1004,บางรัก,มหาพฤฒาราม,ตรอกขุนนาวา,ชุมชนเมือง,984,347,637
1004,บางรัก,มหาพฤฒาราม,ตรอกห้านาย,ชุมชนเมือง,958,447,511
1004,บางรัก,มหาพฤฒาราม,ซอยจอมสมบูรณ์,ชุมชนเมือง,619,218,401
1004,บางรัก,มหาพฤฒาราม,ซอยพระนคเรศ,ชุมชนเมือง,548,231,317
1004,บางรัก,มหาพฤฒาราม,ซอยหลังวัดแก้วแจ่มฟ้า (สี่พระยา),ชุมชนเมือง,2845,1252,1593
1004,บางรัก,สีลม,ซอยพิพัฒน์ 2,ชุมชนแออัด,1080,493,587
1004,บางรัก,สีลม,ซอยไวตี,ชุมชนแออัด,618,314,304
1004,บางรัก,สีลม,ศรีเวียง (ชุมชนตรงข้ามโรงเรียนฝึกอาชีพ กทม.),ชุมชนเมือง,1365,645,720
1004,บางรัก,บางรัก,ซอยวัดม่วงแคมัสยิดฮารูณ,ชุมชนเมือง,935,414,521
1004,บางรัก,สี่พระยา,ซอยหลังวัดหัวลำโพง,ชุมชนแออัด,390,184,206
1004,บางรัก,สี่พระยา,ซอยสันติภาพ,ชุมชนเมือง,604,257,347
1004,บางรัก,สี่พระยา,ตลาดสดเพชรพลอย,ชุมชนเมือง,1561,667,894
1004,บางรัก,สี่พระยา,แฟลตครอบครัวสถานีตำรวจนครบาลบางรัก,ชุมชนอาคารสูง,300,169,131
1027,บึงกุ่ม,คลองกุ่ม,ข้างหมู่บ้านสหกรณ์ (โต๊ะบางอุปถัมภ์),ชุมชนแออัด,436,208,228
1027,บึงกุ่ม,คลองกุ่ม,ซอยรอดอนันต์ 1,ชุมชนแออัด,1157,543,614
1027,บึงกุ่ม,คลองกุ่ม,ซอยสมหวัง,ชุมชนแออัด,972,491,481
1027,บึงกุ่ม,คลองกุ่ม,วัดพิชัย,ชุมชนแออัด,754,369,385
1027,บึงกุ่ม,คลองกุ่ม,สุวรรณประสิทธิ์ 1,ชุมชนแออัด,427,210,217
1027,บึงกุ่ม,คลองกุ่ม,สุวรรณประสิทธิ์ 2,ชุมชนแออัด,325,165,160
1027,บึงกุ่ม,คลองกุ่ม,สุวรรณประสิทธิ์ 3,ชุมชนแออัด,559,270,289
1027,บึงกุ่ม,คลองกุ่ม,อัสลามคลองกุ่ม,ชุมชนแออัด,1497,782,715
1027,บึงกุ่ม,คลองกุ่ม,หมู่บ้านเสริมมิตร,ชุมชนเมือง,1007,475,532
1027,บึงกุ่ม,คลองกุ่ม,หมู่บ้านธนะสิน โครงการ 1,ชุมชนเมือง,955,472,483
1027,บึงกุ่ม,คลองกุ่ม,หมู่บ้านวังทองวิลล่า,ชุมชนเมือง,647,301,346
1027,บึงกุ่ม,คลองกุ่ม,เพชรคลองจั่น,ชุมชนแออัด,343,181,162
1027,บึงกุ่ม,คลองกุ่ม,วัดบางเตยล่าง,ชุมชนแออัด,164,66,98
1027,บึงกุ่ม,คลองกุ่ม,หมู่บ้านคลองกุ่มนิเวศน์,ชุมชนเมือง,2973,1410,1563
1027,บึงกุ่ม,คลองกุ่ม,หมู่บ้านธนะสิน โครงการ 5-6,ชุมชนเมือง,1556,678,878
1027,บึงกุ่ม,คลองกุ่ม,หมู่บ้านปัฐวิกรณ์ 1,ชุมชนเมือง,1459,615,844
1027,บึงกุ่ม,คลองกุ่ม,หมู่บ้านวังทองวิลเลจ 1,ชุมชนเมือง,1025,447,578
1027,บึงกุ่ม,คลองกุ่ม,สามัคคีพัฒนา,ชุมชนแออัด,2132,997,1135
1027,บึงกุ่ม,คลองกุ่ม,หมู่บ้านสุวรรณนิเวศน์,ชุมชนเมือง,3475,1545,1930
1027,บึงกุ่ม,คลองกุ่ม,นวกานต์,ชุมชนเมือง,482,225,257
1027,บึงกุ่ม,คลองกุ่ม,แก้วฟ้าชัยมงคล,ชุมชนเมือง,150,64,86
1027,บึงกุ่ม,นวมินทร์,หมู่บ้านสราญรมย์,ชุมชนเมือง,1430,667,763
1027,บึงกุ่ม,นวมินทร์,หมู่บ้านสามัคคี 53,ชุมชนเมือง,1679,797,882
1027,บึงกุ่ม,นวมินทร์,หลังหมู่บ้านฉัตรแก้ว,ชุมชนชานเมือง,283,128,155
1027,บึงกุ่ม,นวมินทร์,ซอยจิตต์ภักดี,ชุมชนเมือง,494,228,266
1027,บึงกุ่ม,นวมินทร์,หมู่บ้านอินทรารักษ์ 2,ชุมชนเมือง,901,378,523
1027,บึงกุ่ม,นวลจันทร์,ข้างโรงเรียนสายอักษร,ชุมชนแออัด,166,94,72
1027,บึงกุ่ม,นวลจันทร์,นวลจันทร์,ชุมชนแออัด,750,420,330
1027,บึงกุ่ม,นวลจันทร์,โพธิ์ทอง,ชุมชนแออัด,328,170,158
1027,บึงกุ่ม,นวลจันทร์,หมู่บ้านร่มไทรวิลล่า,ชุมชนเมือง,953,430,523
1027,บึงกุ่ม,นวลจันทร์,หมู่บ้านเสริมศิริ,ชุมชนเมือง,488,192,296
1027,บึงกุ่ม,นวลจันทร์,หมู่บ้านคลองจั่นวิลล่า 2,ชุมชนเมือง,413,180,233
1027,บึงกุ่ม,นวลจันทร์,หมู่บ้านวรรณจิตร,ชุมชนเมือง,236,95,141
1027,บึงกุ่ม,นวลจันทร์,ชูสุวรรณ,ชุมชนแออัด,614,234,380
1027,บึงกุ่ม,นวลจันทร์,หมู่บ้านอัมรินทร์นิเวศน์ 2,ชุมชนเมือง,452,202,250
1027,บึงกุ่ม,นวลจันทร์,หมู่บ้านเคหะธานี 2 รามอินทรา,ชุมชนเมือง,2205,1027,1178
1027,บึงกุ่ม,นวลจันทร์,หมู่บ้านธนะธานี 3,ชุมชนเมือง,358,195,163
1007,ปทุมวัน,รองเมือง,บ้านครัวใต้,ชุมชนแออัด,1280,616,664
1007,ปทุมวัน,รองเมือง,ชาวชูชีพ,ชุมชนแออัด,326,151,175
1007,ปทุมวัน,รองเมือง,ตรอกสลักหิน,ชุมชนแออัด,633,304,329
1007,ปทุมวัน,รองเมือง,วัดบรมนิวาส,ชุมชนแออัด,1068,500,568
1007,ปทุมวัน,รองเมือง,วัดชัยมงคล (ศาลเจ้าแป๊ะกง),ชุมชนแออัด,748,349,399
1007,ปทุมวัน,รองเมือง,วัดสามง่าม,ชุมชนเมือง,445,245,200
1007,ปทุมวัน,รองเมือง,แฟลตการรถไฟ,ชุมชนอาคารสูง,205,105,100
1007,ปทุมวัน,รองเมือง,วัดดวงแข,ชุมชนแออัด,294,130,164
1007,ปทุมวัน,รองเมือง,จรัสเมือง,ชุมชนเมือง,159,72,87
1007,ปทุมวัน,รองเมือง,ริมคลองนางหงส์,ชุมชนแออัด,655,285,370
1007,ปทุมวัน,วังใหม่,แฟลตสถานีตำรวจนครบาลปทุมวัน,ชุมชนอาคารสูง,407,236,171
1007,ปทุมวัน,ปทุมวัน,หลังวัดปทุมวนาราม,ชุมชนแออัด,1789,751,1038
1007,ปทุมวัน,ลุมพินี,ซอยโปโล,ชุมชนแออัด,623,297,326
1007,ปทุมวัน,ลุมพินี,ซอยพระเจน,ชุมชนแออัด,5007,2135,2872
1007,ปทุมวัน,ลุมพินี,ซอยร่วมฤดี,ชุมชนแออัด,1725,820,905
1007,ปทุมวัน,ลุมพินี,พัฒนาบ่อนไก่,ชุมชนแออัด,1905,914,991
1007,ปทุมวัน,ลุมพินี,เคหะชุมชนบ่อนไก่,ชุมชนอาคารสูง,7428,3138,4290
1032,ประเวศ,ประเวศ,กระทุ่มเสือปลา,ชุมชนเมือง,3150,1586,1564
1032,ประเวศ,ประเวศ,เกาะมุสลิม,ชุมชนแออัด,582,222,360
1032,ประเวศ,ประเวศ,เกาะเลิ้งสัมพันธ์,ชุมชนเมือง,2545,1155,1390
1032,ประเวศ,ประเวศ,คลองมอญ,ชุมชนเมือง,461,238,223
1032,ประเวศ,ประเวศ,ทับช้างล่างฝั่งธน,ชุมชนเมือง,850,400,450
1032,ประเวศ,ประเวศ,เทพรักษา,ชุมชนแออัด,579,283,296
1032,ประเวศ,ประเวศ,บ้านบึง,ชุมชนเมือง,798,440,358
1032,ประเวศ,ประเวศ,เปรมฤทัย 72-74,ชุมชนเมือง,2162,1051,1111
1032,ประเวศ,ประเวศ,ริมคลองประเวศ,ชุมชนเมือง,1120,448,672
1032,ประเวศ,ประเวศ,ริมคลองประเวศฝั่งเหนือ,ชุมชนเมือง,784,353,431
1032,ประเวศ,ประเวศ,สามัคคีธรรม,ชุมชนแออัด,451,173,278
1032,ประเวศ,ประเวศ,สุขาภิบาล 2 (ซอยโรงถ่าน),ชุมชนเมือง,700,400,300
1032,ประเวศ,ประเวศ,สุเหร่าจรเข้ขบ,ชุมชนเมือง,1735,873,862
1032,ประเวศ,ประเวศ,สุเหร่าทางควาย,ชุมชนเมือง,790,343,447
1032,ประเวศ,ประเวศ,สุเหร่าบึงหนองบอน,ชุมชนเมือง,1573,744,829
1032,ประเวศ,ประเวศ,หมู่บ้านพัฒนาศาลาลอย,ชุมชนเมือง,1355,628,727
1032,ประเวศ,ประเวศ,หลัง สน.เก่าประเวศ,ชุมชนเมือง,172,92,80
1032,ประเวศ,ประเวศ,อ่อนนุช (40 ไร่),ชุมชนเมือง,2985,1465,1520
1032,ประเวศ,ประเวศ,บ้านม้า,ชุมชนเมือง,1072,506,566
1032,ประเวศ,ประเวศ,เกาะกลาง,ชุมชนเมือง,1760,750,1010
1032,ประเวศ,ประเวศ,อาคารสงเคราะห์ฯ อ่อนนุช 86,ชุมชนอาคารสูง,539,250,289
1032,ประเวศ,ประเวศ,ปากคลองสองห้อง,ชุมชนเมือง,401,192,209
1032,ประเวศ,ประเวศ,คลองมะขามเทศพัฒนา,ชุมชนเมือง,230,118,112
1032,ประเวศ,ประเวศ,จรเข้ขบเกาะล่าง,ชุมชนเมือง,328,108,220
1032,ประเวศ,ประเวศ,หมู่บ้านสุธาทิพย์,ชุมชนเมือง,662,338,324
1032,ประเวศ,ประเวศ,อ่อนนุช 53 ฝั่งซ้าย,ชุมชนเมือง,826,341,485
1032,ประเวศ,หนองบอน,ชอุ่ม 2,ชุมชนเมือง,800,408,392
1032,ประเวศ,หนองบอน,เปรมฤทัย 20,ชุมชนเมือง,3345,1450,1895
1032,ประเวศ,หนองบอน,มิตรภาพ ซอย 6,ชุมชนเมือง,913,433,480
1032,ประเวศ,หนองบอน,เราะห์มาตุ้ลอิสลาม,ชุมชนเมือง,569,245,324
1032,ประเวศ,หนองบอน,สุเหร่าคลองเคล็ด,ชุมชนเมือง,1203,693,510
1032,ประเวศ,หนองบอน,หมู่บ้านร่มเย็น,ชุมชนเมือง,560,286,274
1032,ประเวศ,หนองบอน,ซอยร่มเย็น,ชุมชนเมือง,705,339,366
1032,ประเวศ,หนองบอน,ร่วมใจพัฒนา,ชุมชนเมือง,1209,287,922
1032,ประเวศ,หนองบอน,เคหะนคร 3,ชุมชนเมือง,516,242,274
1032,ประเวศ,ดอกไม้,มัสยิดดอกไม้,ชุมชนเมือง,1665,743,922
1032,ประเวศ,ดอกไม้,อ่อนนุช 19 ไร่,ชุมชนเมือง,2345,1149,1196
1032,ประเวศ,ดอกไม้,อ่อนนุช 14 ไร่ (ใต้สะพาน),ชุมชนเมือง,542,263,279
1032,ประเวศ,ดอกไม้,อาคารบ้านพักตำรวจส่วนกลาง (อุดมสุข),ชุมชนอาคารสูง,2932,1418,1514
1032,ประเวศ,ดอกไม้,เปรมฤทัย ล๊อค 17,ชุมชนเมือง,784,382,402
1032,ประเวศ,ดอกไม้,กระทุ่มแจ้พัฒนา,ชุมชนเมือง,571,202,369
1032,ประเวศ,ดอกไม้,คลองปักหลักพัฒนา,ชุมชนเมือง,472,221,251
1032,ประเวศ,ดอกไม้,สหกรณ์เคหสถานชุมชนบัวหลวงจำกัด,ชุมชนอาคารสูง,349,165,184
1032,ประเวศ,ดอกไม้,ดอกไม้,ชุมชนเมือง,639,319,320
1032,ประเวศ,ดอกไม้,คลองสิงห์โต,ชุมชนชานเมือง,436,221,215
1008,ป้อมปราบศัตรูพ่าย,ป้อมปราบ,ตรอกมะขาม,ชุมชนเมือง,687,327,360
1008,ป้อมปราบศัตรูพ่าย,คลองมหานาค,มัสยิดมหานาค,ชุมชนแออัด,924,453,471
1008,ป้อมปราบศัตรูพ่าย,คลองมหานาค,สิตาราม,ชุมชนแออัด,143,80,63
1008,ป้อมปราบศัตรูพ่าย,คลองมหานาค,ดำรงรักษ์,ชุมชนเมือง,310,147,163
1008,ป้อมปราบศัตรูพ่าย,คลองมหานาค,วุฒิชัย,ชุมชนเมือง,289,119,170
1008,ป้อมปราบศัตรูพ่าย,บ้านบาตร,บ้านบาตร,ชุมชนแออัด,873,409,464
1008,ป้อมปราบศัตรูพ่าย,บ้านบาตร,วัดสระเกศ,ชุมชนแออัด,273,132,141
1008,ป้อมปราบศัตรูพ่าย,บ้านบาตร,วังแดง,ชุมชนเมือง,376,184,192
1008,ป้อมปราบศัตรูพ่าย,บ้านบาตร,บ้านดอกไม้,ชุมชนแออัด,713,349,364
1008,ป้อมปราบศัตรูพ่าย,วัดโสมนัส,จักรพรรดิพงษ์,ชุมชนแออัด,206,93,113
1008,ป้อมปราบศัตรูพ่าย,วัดโสมนัส,วัดสุนทรธรรมทาน,ชุมชนแออัด,943,481,462
1008,ป้อมปราบศัตรูพ่าย,วัดโสมนัส,วัดโสมนัส,ชุมชนแออัด,777,350,427
1008,ป้อมปราบศัตรูพ่าย,วัดโสมนัส,ศุภมิตร 1,ชุมชนแออัด,538,249,289
1008,ป้อมปราบศัตรูพ่าย,วัดโสมนัส,ศุภมิตร 2,ชุมชนแออัด,1280,602,678
1014,พญาไท,สามเสนใน,อินทามระ 29 แยก 1,ชุมชนแออัด,281,126,155
1014,พญาไท,สามเสนใน,อินทามระ 1 (ลับแล),ชุมชนแออัด,488,218,270
1014,พญาไท,สามเสนใน,บุญชูศรี,ชุมชนแออัด,170,68,102
1014,พญาไท,สามเสนใน,เป็นสุข,ชุมชนแออัด,300,135,165
1014,พญาไท,สามเสนใน,อินทามระ 29 แยก 4,ชุมชนแออัด,268,128,140
1014,พญาไท,สามเสนใน,สนามเป้า,ชุมชนอาคารสูง,3870,1897,1973
1014,พญาไท,สามเสนใน,สวนมิสกวัน,ชุมชนอาคารสูง,805,448,357
1014,พญาไท,สามเสนใน,ราชวัลลภ 1,ชุมชนอาคารสูง,809,407,402
1014,พญาไท,สามเสนใน,อินทามระ 11,ชุมชนแออัด,748,369,379
1014,พญาไท,สามเสนใน,ดุริยางค์ทหารบก,ชุมชนอาคารสูง,813,394,419
1014,พญาไท,สามเสนใน,แฟลตตำรวจส่วนกลางเฉลิมลาภ,ชุมชนอาคารสูง,2720,1496,1224
1014,พญาไท,สามเสนใน,แฟลต สน. บางซื่อ,ชุมชนอาคารสูง,451,290,161
1014,พญาไท,พญาไท,ถวัลย์ศักดิ์,ชุมชนแออัด,441,198,243
1014,พญาไท,พญาไท,วัดมะกอก(กลางสวน),ชุมชนแออัด,576,270,306
1014,พญาไท,พญาไท,สุขสวัสดิ์,ชุมชนแออัด,251,132,119
1014,พญาไท,พญาไท,อุทัยรัตน์,ชุมชนแออัด,2218,1035,1183
1014,พญาไท,พญาไท,วัดมะกอกส่วนหน้า,ชุมชนแออัด,595,323,272
1014,พญาไท,พญาไท,อาเซี่ยน,ชุมชนแออัด,474,246,228
1014,พญาไท,พญาไท,วัดไผ่ตัน,ชุมชนแออัด,1447,714,733
1014,พญาไท,พญาไท,แฟลตลือชา,ชุมชนอาคารสูง,3108,1400,1708
1014,พญาไท,พญาไท,แฟลต ทบ. สามเสน,ชุมชนอาคารสูง,1901,949,952
1014,พญาไท,พญาไท,ตชด.ลือชา,ชุมชนอาคารสูง,224,127,97
1009,พระโขนง,บางจาก,เกตุไพเราะ 1-2,ชุมชนแออัด,147,71,76
1009,พระโขนง,บางจาก,เกตุไพเราะ 3-5,ชุมชนแออัด,512,234,278
1009,พระโขนง,บางจาก,เชลียง 5,ชุมชนแออัด,1022,512,510
1009,พระโขนง,บางจาก,ซอยประดับสุข,ชุมชนแออัด,528,261,267
1009,พระโขนง,บางจาก,ซอยเปี่ยมสุข,ชุมชนแออัด,523,260,263
1009,พระโขนง,บางจาก,เซ่งไพเราะ,ชุมชนแออัด,427,209,218
1009,พระโขนง,บางจาก,ทุ่งสาธิต,ชุมชนแออัด,229,115,114
1009,พระโขนง,บางจาก,บุญกุศล,ชุมชนแออัด,306,122,184
1009,พระโขนง,บางจาก,แย้มสรวล,ชุมชนแออัด,840,403,437
1009,พระโขนง,บางจาก,ร่วมสามัคคี,ชุมชนแออัด,426,215,211
1009,พระโขนง,บางจาก,ฤกษ์เที่ยง,ชุมชนแออัด,188,82,106
1009,พระโขนง,บางจาก,สาหร่ายไพเราะ,ชุมชนแออัด,385,191,194
1009,พระโขนง,บางจาก,สุขุมวิท 93,ชุมชนแออัด,312,141,171
1009,พระโขนง,บางจาก,สุนทรธรรม,ชุมชนแออัด,745,345,400
1009,พระโขนง,บางจาก,สาหร่ายทองคำ,ชุมชนแออัด,482,224,258
1009,พระโขนง,บางจาก,สุภาพงษ์,ชุมชนแออัด,504,238,266
1009,พระโขนง,บางจาก,หมู่บ้านนิรันดร์วิลล่า,ชุมชนเมือง,4070,1885,2185
1009,พระโขนง,บางจาก,หมู่บ้านทับแก้ว,ชุมชนเมือง,934,317,617
1009,พระโขนง,บางจาก,สองพี่น้อง,ชุมชนแออัด,314,154,160
1009,พระโขนง,บางจาก,หมู่บ้านศรัณจิต 1,ชุมชนเมือง,400,180,220
1009,พระโขนง,บางจาก,หมู่บ้านยศศักดิ์นิเวศน์,ชุมชนเมือง,188,62,126
1009,พระโขนง,บางจาก,หมู่บ้านการท่าเรือ,ชุมชนเมือง,482,208,274
1009,พระโขนง,บางจาก,หมู่บ้านซอยสวัสดี,ชุมชนแออัด,90,45,45
1009,พระโขนง,บางจาก,หมู่บ้านไทยอาคาร,ชุมชนเมือง,622,290,332
1009,พระโขนง,บางจาก,หมู่บ้านสุขสุวรรณ,ชุมชนเมือง,154,84,70
1009,พระโขนง,บางจาก,หมู่บ้านศรัณจิต 4,ชุมชนเมือง,493,243,250
1009,พระโขนง,บางจาก,เยี่ยมเจริญสุข,ชุมชนแออัด,436,209,227
1009,พระโขนง,บางจาก,ประวิทย์สามัคคี,ชุมชนเมือง,221,101,120
1009,พระโขนง,บางจาก,หมู่บ้านสุขใจ,ชุมชนเมือง,321,122,199
1009,พระโขนง,บางจาก,บึงบัว 53,ชุมชนเมือง,341,167,174
1009,พระโขนง,บางจาก,หมู่บ้านศรัณจิต 2,ชุมชนเมือง,292,130,162
1009,พระโขนง,บางจาก,มิตรพัฒนา-มาลีอนุสรณ์,ชุมชนเมือง,994,450,544
1009,พระโขนง,บางจาก,หมู่บ้านรุ่งเจริญ 1,ชุมชนเมือง,286,122,164
1009,พระโขนง,บางจาก,หมู่บ้านรุ่งเจริญ 2,ชุมชนเมือง,271,126,145
1009,พระโขนง,บางจาก,หมู่บ้านรุ่งอรุณ,ชุมชนเมือง,370,170,200
1009,พระโขนง,บางจาก,หมู่บ้านไทยวันดี,ชุมชนเมือง,708,324,384
1009,พระโขนง,บางจาก,หมู่บ้านธรรมสาธิตวิลล่า,ชุมชนเมือง,2095,892,1203
1009,พระโขนง,พระโขนงใต้,ข้างโรงกลั่นน้ำมันบางจาก,ชุมชนแออัด,498,256,242
1009,พระโขนง,พระโขนงใต้,พงษ์เวชอนุสรณ์,ชุมชนแออัด,278,137,141
1009,พระโขนง,พระโขนงใต้,หน้าโรงเรียนบางจาก,ชุมชนแออัด,1264,554,710
1009,พระโขนง,พระโขนงใต้,หน้าวัดบุญรอดธรรมาราม,ชุมชนแออัด,694,324,370
1009,พระโขนง,พระโขนงใต้,หลังวัดบุญรอดธรรมาราม,ชุมชนแออัด,504,264,240
1009,พระโขนง,พระโขนงใต้,เล็กเที่ยง,ชุมชนแออัด,214,105,109
1009,พระโขนง,พระโขนงใต้,บ้านสวนร่วมพัฒนา,ชุมชนเมือง,509,269,240
1009,พระโขนง,พระโขนงใต้,รวมใจพัฒนา,ชุมชนเมือง,365,173,192
1001,พระนคร,พระบรมมหาราชวัง,ท่าวัง,ชุมชนแออัด,364,176,188
1001,พระนคร,พระบรมมหาราชวัง,ท่าเตียน,ชุมชนเมือง,608,274,334
1001,พระนคร,วัดราชบพิธ,ราชบพิธพัฒนา,ชุมชนเมือง,1502,652,850
1001,พระนคร,วัดราชบพิธ,ตรอกเฟื่องทอง-ตรอกวิสูตร,ชุมชนเมือง,1776,846,930
1001,พระนคร,สำราญราษฎร์,วัดเทพธิดาราม,ชุมชนเมือง,441,217,224
1001,พระนคร,ศาลเจ้าพ่อเสือ,แพร่งภูธร,ชุมชนเมือง,407,184,223
1001,พระนคร,เสาชิงช้า,โบสถ์พราหมณ์,ชุมชนเมือง,1270,808,462
1001,พระนคร,บวรนิเวศ,ตรอกศิลป์-ตรอกตึกดิน,ชุมชนเมือง,434,195,239
1001,พระนคร,บวรนิเวศ,บวรรังษี,ชุมชนเมือง,200,95,105
1001,พระนคร,บวรนิเวศ,มัสยิดบ้านตึกดิน,ชุมชนเมือง,265,130,135
1001,พระนคร,บวรนิเวศ,หลังวัดราชนัดดา,ชุมชนเมือง,560,228,332
1001,พระนคร,ชนะสงคราม,ตรอกเขียนนิวาศน์,ชุมชนเมือง,505,234,271
1001,พระนคร,ชนะสงคราม,มัสยิดจักรพงษ์,ชุมชนแออัด,336,158,178
1001,พระนคร,บ้านพานถม,ตรอกบ้านพานถม,ชุมชนแออัด,1795,755,1040
1001,พระนคร,บ้านพานถม,วัดใหม่อมตรส,ชุมชนเมือง,1420,700,720
1001,พระนคร,บางขุนพรหม,วัดอินทรวิหาร,ชุมชนแออัด,833,409,424
1001,พระนคร,วัดสามพระยา,วัดนรนารถ (ตรอกปูเค็ม),ชุมชนเมือง,176,84,92
1001,พระนคร,วัดสามพระยา,วัดสามพระยา,ชุมชนแออัด,544,265,279
1001,พระนคร,วัดสามพระยา,วัดสังเวชวิศยาราม,ชุมชนเมือง,1085,494,591
1022,ภาษีเจริญ,บางหว้า,คลองตาแป้น,ชุมชนเมือง,2378,1150,1228
1022,ภาษีเจริญ,บางหว้า,คานเรือ,ชุมชนเมือง,449,205,244
1022,ภาษีเจริญ,บางหว้า,ซอยวัดโคนอน,ชุมชนเมือง,1038,438,600
1022,ภาษีเจริญ,บางหว้า,เพชรเกษม 42,ชุมชนเมือง,1015,489,526
1022,ภาษีเจริญ,บางหว้า,เพชรเกษม 44,ชุมชนเมือง,401,189,212
1022,ภาษีเจริญ,บางหว้า,วัดรางบัว,ชุมชนแออัด,325,110,215
1022,ภาษีเจริญ,บางหว้า,สุภัทรภิบาล,ชุมชนแออัด,1276,603,673
1022,ภาษีเจริญ,บางหว้า,หน้าวัดโคนอน,ชุมชนเมือง,1066,446,620
1022,ภาษีเจริญ,บางหว้า,หมู่บ้านพัฒนา หมู่ 7 บางหว้า,ชุมชนชานเมือง,270,139,131
1022,ภาษีเจริญ,บางหว้า,หลังวัดรางบัว,ชุมชนเมือง,266,121,145
1022,ภาษีเจริญ,บางหว้า,หมู่บ้านตวงทอง,ชุมชนเมือง,2485,1000,1485
1022,ภาษีเจริญ,บางหว้า,หมู่บ้านอินทราวิลล่า,ชุมชนเมือง,3295,1302,1993
1022,ภาษีเจริญ,บางหว้า,แสงหิรัญ,ชุมชนแออัด,615,296,319
1022,ภาษีเจริญ,บางหว้า,ริมคลองภาษีเจริญ บางหว้า หมู่ 15,ชุมชนเมือง,349,163,186
1022,ภาษีเจริญ,บางหว้า,กัลปพฤกษ์ หมู่ 4,ชุมชนเมือง,975,362,613
1022,ภาษีเจริญ,บางหว้า,หมู่ 6 ร่วมใจ,ชุมชนเมือง,220,104,116
1022,ภาษีเจริญ,บางด้วน,เทพประทาน,ชุมชนเมือง,587,268,319
1022,ภาษีเจริญ,บางด้วน,เพชรเกษม 56,ชุมชนแออัด,264,112,152
1022,ภาษีเจริญ,บางด้วน,เพชรเกษม 58,ชุมชนแออัด,778,450,328
1022,ภาษีเจริญ,บางด้วน,ริมคลองราชมนตรี หมู่ 10,ชุมชนเมือง,2990,1315,1675
1022,ภาษีเจริญ,บางด้วน,ริมคลองราชมนตรี หมู่ 11,ชุมชนเมือง,744,365,379
1022,ภาษีเจริญ,บางด้วน,วัดจันทร์ประดิษฐาราม เขต 1 หมู่ 1 หมู่ 7,ชุมชนเมือง,984,483,501
1022,ภาษีเจริญ,บางด้วน,วัดจันทร์ประดิษฐาราม เขต 1 หมู่ 3,ชุมชนแออัด,597,298,299
1022,ภาษีเจริญ,บางด้วน,วัดจันทร์ประดิษฐาราม เขต 2,ชุมชนแออัด,822,371,451
1022,ภาษีเจริญ,บางด้วน,วัดจันทร์ประดิษฐาราม เขต 3,ชุมชนแออัด,1090,498,592
1022,ภาษีเจริญ,บางด้วน,วัดจันทร์ประดิษฐาราม เขต 4,ชุมชนแออัด,554,257,297
1022,ภาษีเจริญ,บางด้วน,วัดจันทร์ประดิษฐาราม เขต 5,ชุมชนแออัด,1163,595,568
1022,ภาษีเจริญ,บางด้วน,วัดจันทร์ประดิษฐาราม เขต 1 หมู่ 7,ชุมชนเมือง,725,338,387
1022,ภาษีเจริญ,บางด้วน,จันทร์รวมใจ,ชุมชนเมือง,1200,455,745
1022,ภาษีเจริญ,บางด้วน,จันทรังษี,ชุมชนเมือง,830,388,442
1022,ภาษีเจริญ,บางด้วน,เลิศสุขสม,ชุมชนชานเมือง,812,389,423
1022,ภาษีเจริญ,บางด้วน,คลองลัดภาชี,ชุมชนเมือง,364,170,194
1022,ภาษีเจริญ,บางด้วน,แป๊ะกงร่วมใจ,ชุมชนเมือง,576,226,350
1022,ภาษีเจริญ,บางด้วน,ราศรีธรรม,ชุมชนเมือง,403,188,215
1022,ภาษีเจริญ,บางจาก,ศรีประดู่,ชุมชนเมือง,318,141,177
1022,ภาษีเจริญ,บางจาก,ศิรินทร์และเพื่อน,ชุมชนเมือง,878,508,370
1022,ภาษีเจริญ,บางจาก,พื้นที่สุขภาวะหลัง ม.สยาม รุ่งฟ้า 36,ชุมชนเมือง,918,455,463
1022,ภาษีเจริญ,บางแวก,ข้างวัดโตนด,ชุมชนเมือง,431,179,252
1022,ภาษีเจริญ,บางแวก,หลังวัดปากน้ำฝั่งใต้,ชุมชนเมือง,726,315,411
1022,ภาษีเจริญ,คูหาสวรรค์,ข้างวัดบางแวก,ชุมชนแออัด,455,195,260
1022,ภาษีเจริญ,บางแวก,หมู่บ้านนวมประดิษฐ์,ชุมชนเมือง,900,450,450
1022,ภาษีเจริญ,บางแวก,หมู่ 4 ชาวบางแวก,ชุมชนเมือง,451,176,275
1022,ภาษีเจริญ,บางแวก,หมู่ 5 บางแวก,ชุมชนเมือง,701,226,475
1022,ภาษีเจริญ,คลองขวาง,เจริญวิถี,ชุมชนเมือง,865,420,445
1022,ภาษีเจริญ,คลองขวาง,หมู่บ้านพัฒนาหมู่ 1 คลองขวาง,ชุมชนเมือง,669,294,375
1022,ภาษีเจริญ,คลองขวาง,ซอยพูนบำเพ็ญ,ชุมชนเมือง,560,248,312
1022,ภาษีเจริญ,คลองขวาง,ราชมนตรีร่วมใจ (โครงการบางแวก),ชุมชนเมือง,458,201,257
1022,ภาษีเจริญ,ปากคลองภาษีเจริญ,กำแพงทองพัฒนา,ชุมชนเมือง,2040,987,1053
1022,ภาษีเจริญ,คูหาสวรรค์,หลังวัดคูหาสวรรค์,ชุมชนเมือง,1500,644,856
1022,ภาษีเจริญ,คูหาสวรรค์,วิจิตรสัมพันธ์,ชุมชนเมือง,485,195,290
1022,ภาษีเจริญ,คูหาสวรรค์,วิจิตรสามัคคี,ชุมชนเมือง,283,134,149
1010,มีนบุรี,มีนบุรี,บางชันพัฒนา หมู่ 15,ชุมชนเมือง,1112,700,412
1010,มีนบุรี,มีนบุรี,มีนบุรีอุปถัมภ์ หมู่ 9,ชุมชนแออัด,727,379,348
1010,มีนบุรี,มีนบุรี,รามอินทราเนรมิต หมู่ 3,ชุมชนเมือง,5695,2635,3060
1010,มีนบุรี,มีนบุรี,หมู่บ้านธรากร,ชุมชนเมือง,4460,2055,2405
1010,มีนบุรี,มีนบุรี,หมู่บ้านปรีชา 10,ชุมชนเมือง,2064,992,1072
1010,มีนบุรี,มีนบุรี,วังทองพัฒนา,ชุมชนชานเมือง,548,266,282
1010,มีนบุรี,มีนบุรี,หมู่บ้านสุภาวัลย์-เทพารักษ์,ชุมชนเมือง,1045,476,569
1010,มีนบุรี,มีนบุรี,ลำนายโส หมู่ 20,ชุมชนชานเมือง,666,326,340
1010,มีนบุรี,มีนบุรี,หมู่บ้านปรีชา 11 หมู่ 3,ชุมชนเมือง,967,445,522
1010,มีนบุรี,มีนบุรี,หมู่บ้านสินธานี 2 หมู่ 3,ชุมชนเมือง,1110,518,592
1010,มีนบุรี,มีนบุรี,นูรุ้ลพัฒนา หมู่ 5,ชุมชนเมือง,408,203,205
1010,มีนบุรี,มีนบุรี,สามัคคีคลองสองต้นนุ่น หมู่ 7,ชุมชนชานเมือง,1240,577,663
1010,มีนบุรี,มีนบุรี,หมู่บ้านพนาสนธิ์วิลล่า 3,ชุมชนเมือง,625,287,338
1010,มีนบุรี,มีนบุรี,บ้านคูคตพัฒนา,ชุมชนเมือง,1600,790,810
1010,มีนบุรี,มีนบุรี,มัสยิดอัตตั๊กวาพัฒนา (คลองสองต้นนุ่น),ชุมชนชานเมือง,1621,780,841
1010,มีนบุรี,มีนบุรี,หมู่บ้านอัญชลี,ชุมชนเมือง,812,405,407
1010,มีนบุรี,มีนบุรี,หมู่บ้านร่วมสุข 2,ชุมชนเมือง,265,118,147
1010,มีนบุรี,มีนบุรี,สามัคคีธรรม,ชุมชนชานเมือง,1290,554,736
1010,มีนบุรี,มีนบุรี,หมู่บ้านเค.ซี.ร่มเกล้า,ชุมชนเมือง,903,372,531
1010,มีนบุรี,มีนบุรี,หมู่บ้านรุ่งนภาเพลส,ชุมชนเมือง,1200,594,606
1010,มีนบุรี,มีนบุรี,เคหะชุมชนบางชัน,ชุมชนอาคารสูง,1773,850,923
1010,มีนบุรี,มีนบุรี,บัวขาวฝั่งใน,ชุมชนเมือง,1701,741,960
1010,มีนบุรี,มีนบุรี,หมู่บ้านวาสนา,ชุมชนเมือง,441,188,253
1010,มีนบุรี,มีนบุรี,แสนสุขพัฒนา,ชุมชนชานเมือง,252,110,142
1010,มีนบุรี,มีนบุรี,หมู่บ้านบัวขาว,ชุมชนเมือง,3036,1540,1496
1010,มีนบุรี,มีนบุรี,พิเชษฐ์,ชุมชนเมือง,895,453,442
1010,มีนบุรี,มีนบุรี,โรงช้อน,ชุมชนเมือง,960,430,530
1010,มีนบุรี,มีนบุรี,รุ่งนภา 2,ชุมชนเมือง,620,290,330
1010,มีนบุรี,มีนบุรี,หมู่บ้านรินทร์ทอง,ชุมชนเมือง,5456,2183,3273
1010,มีนบุรี,มีนบุรี,ประชาพัฒนา,ชุมชนชานเมือง,257,114,143
1010,มีนบุรี,มีนบุรี,นิมิตใหม่ ซอย 1,ชุมชนเมือง,1156,528,628
1010,มีนบุรี,แสนแสบ,โซ๊ะมันร่วมพัฒนา หมู่ 8,ชุมชนชานเมือง,820,340,480
1010,มีนบุรี,แสนแสบ,ทองสงวน หมู่ 9,ชุมชนชานเมือง,2335,1215,1120
1010,มีนบุรี,แสนแสบ,อนันตสามัคคี หมู่ 18,ชุมชนเมือง,536,236,300
1010,มีนบุรี,แสนแสบ,"สุเหร่าบ้านเกาะ หมู่ 4,12",ชุมชนชานเมือง,1468,695,773
1010,มีนบุรี,แสนแสบ,คลองตะโหนด หมู่ 4,ชุมชนชานเมือง,220,220,0
1010,มีนบุรี,แสนแสบ,แสงวิมาน หมู่ 1,ชุมชนชานเมือง,743,370,373
1010,มีนบุรี,แสนแสบ,อิดซ์ฮาร์ดพัฒนา หมู่ 2,ชุมชนชานเมือง,1140,543,597
1010,มีนบุรี,แสนแสบ,ออมทรัพย์,ชุมชนเมือง,848,413,435
1010,มีนบุรี,แสนแสบ,อันนูรอยน์ (บึงขวาง),ชุมชนชานเมือง,1309,647,662
1010,มีนบุรี,แสนแสบ,อับดุลรอมาน,ชุมชนชานเมือง,252,120,132
1010,มีนบุรี,แสนแสบ,ฉัตรหลวง,ชุมชนเมือง,1076,553,523
1010,มีนบุรี,แสนแสบ,อับดุลเลาะ,ชุมชนชานเมือง,693,326,367
1010,มีนบุรี,แสนแสบ,อิดซ์ฮาดร์,ชุมชนชานเมือง,286,141,145
1010,มีนบุรี,แสนแสบ,อนุรักษ์คลองแสนแสบ หมู่ 7,ชุมชนชานเมือง,502,246,256
1010,มีนบุรี,แสนแสบ,อัลฮูดา,ชุมชนชานเมือง,1460,665,795
1010,มีนบุรี,แสนแสบ,สามัคคีพัฒนา,ชุมชนชานเมือง,675,320,355
1010,มีนบุรี,แสนแสบ,หมู่บ้านมีนบุรีการ์เด้นโฮม,ชุมชนเมือง,784,341,443
1010,มีนบุรี,แสนแสบ,พัฒนาบึงขวาง,ชุมชนชานเมือง,807,404,403
1010,มีนบุรี,แสนแสบ,นูรุ้ลอิสลาม (คลองสี่วังเล็ก),ชุมชนชานเมือง,3030,1435,1595
1010,มีนบุรี,แสนแสบ,บึงพระยา,ชุมชนชานเมือง,1300,614,686
1010,มีนบุรี,แสนแสบ,คู้ล่างสร้างสรรค์,ชุมชนชานเมือง,798,395,403
1010,มีนบุรี,แสนแสบ,ภราดรพัฒนา,ชุมชนชานเมือง,1014,482,532
1010,มีนบุรี,แสนแสบ,มิตรปรีดา,ชุมชนชานเมือง,1201,819,382
1010,มีนบุรี,แสนแสบ,สุกกาทอง โครงการ 2,ชุมชนชานเมือง,968,379,589
1010,มีนบุรี,แสนแสบ,หมู่ 6 พัฒนา,ชุมชนชานเมือง,578,292,286
1010,มีนบุรี,แสนแสบ,เคหะสุวินทวงศ์,ชุมชนเมือง,2181,1104,1077
1010,มีนบุรี,แสนแสบ,บ้านเจียระไน,ชุมชนเมือง,287,142,145
1010,มีนบุรี,แสนแสบ,เกาะใหญ่พัฒนา,ชุมชนชานเมือง,688,296,392
1010,มีนบุรี,แสนแสบ,ราษฎร์พัฒนา (ซอยมูลนิธิ),ชุมชนชานเมือง,709,349,360
1010,มีนบุรี,แสนแสบ,วัดทองสัมฤทธิ์,ชุมชนชานเมือง,1594,613,981
1010,มีนบุรี,แสนแสบ,หมู่บ้านปัญฐิญา,ชุมชนเมือง,795,380,415
1012,ยานนาวา,ช่องนนทรี,คลองขวาง,ชุมชนแออัด,734,352,382
1012,ยานนาวา,ช่องนนทรี,คาลเท็กซ์,ชุมชนแออัด,201,103,98
1012,ยานนาวา,ช่องนนทรี,ซอยสรรค์สุข,ชุมชนแออัด,172,69,103
1012,ยานนาวา,ช่องนนทรี,บัวหลวง,ชุมชนแออัด,154,69,85
1012,ยานนาวา,ช่องนนทรี,ร่วมพัฒนาวัดช่องนนทรี,ชุมชนแออัด,2101,979,1122
1012,ยานนาวา,ช่องนนทรี,วัดคลองภูมิ,ชุมชนเมือง,428,188,240
1012,ยานนาวา,ช่องนนทรี,วัดช่องลม,ชุมชนแออัด,962,402,560
1012,ยานนาวา,ช่องนนทรี,เชื้อเพลิงพัฒนา,ชุมชนแออัด,1725,889,836
1012,ยานนาวา,ช่องนนทรี,เย็นอากาศ 2,ชุมชนแออัด,1200,606,594
1012,ยานนาวา,ช่องนนทรี,ร่วมพัฒนาเชื้อเพลิง 2,ชุมชนแออัด,542,226,316
1012,ยานนาวา,ช่องนนทรี,โรงสี,ชุมชนแออัด,1458,682,776
1012,ยานนาวา,ช่องนนทรี,ปากคลองช่องนนทรี,ชุมชนแออัด,202,100,102
1012,ยานนาวา,บางโพงพาง,ซอยพัฒนาการ 1,ชุมชนเมือง,431,229,202
1012,ยานนาวา,บางโพงพาง,ปรีชา 1,ชุมชนเมือง,334,147,187
1012,ยานนาวา,บางโพงพาง,เศตะพราหมณ์,ชุมชนเมือง,442,217,225
1012,ยานนาวา,บางโพงพาง,โสณมัย-อร่ามดวง,ชุมชนแออัด,2580,1085,1495
1012,ยานนาวา,บางโพงพาง,คลองด่าน,ชุมชนเมือง,154,70,84
1037,ราชเทวี,ทุ่งพญาไท,โค้งรถไฟยมราช,ชุมชนแออัด,850,400,450
1037,ราชเทวี,ทุ่งพญาไท,ซอยแดงบุหงา,ชุมชนแออัด,643,236,407
1037,ราชเทวี,ทุ่งพญาไท,ซอยสวนเงิน,ชุมชนแออัด,564,252,312
1037,ราชเทวี,ทุ่งพญาไท,ซอยสุเหร่า,ชุมชนแออัด,2180,980,1200
1037,ราชเทวี,ทุ่งพญาไท,หน้าวัดมะกอก,ชุมชนแออัด,494,230,264
1037,ราชเทวี,ทุ่งพญาไท,สระแก้ว (บ้านพักรถไฟจิตรลดา),ชุมชนแออัด,400,190,210
1037,ราชเทวี,ทุ่งพญาไท,หลังกรมทางหลวง,ชุมชนแออัด,341,148,193
1037,ราชเทวี,ทุ่งพญาไท,ซอยมั่นสิน,ชุมชนแออัด,2195,947,1248
1037,ราชเทวี,ทุ่งพญาไท,กองพลที่ 1 รักษาพระองค์,ชุมชนอาคารสูง,510,295,215
1037,ราชเทวี,ทุ่งพญาไท,กรมแพทย์ทหารบก,ชุมชนอาคารสูง,1350,740,610
1037,ราชเทวี,ทุ่งพญาไท,แฟลตสถานีตำรวจนครบาลพญาไท,ชุมชนอาคารสูง,520,270,250
1037,ราชเทวี,ทุ่งพญาไท,กองพันทหารสารวัตรที่ 11 ที่ 1,ชุมชนอาคารสูง,915,462,453
1037,ราชเทวี,ทุ่งพญาไท,กองพันทหารสารวัตรที่ 11 ที่ 2,ชุมชนอาคารสูง,546,309,237
1037,ราชเทวี,ทุ่งพญาไท,กองพันทหารสารวัตรที่ 11 ที่ 3,ชุมชนอาคารสูง,518,241,277
1037,ราชเทวี,ทุ่งพญาไท,กรมการสารวัตรทหารบก,ชุมชนอาคารสูง,515,289,226
1037,ราชเทวี,ถนนพญาไท,ริมทางรถไฟหลัง ร.พ.เดชา,ชุมชนแออัด,746,327,419
1037,ราชเทวี,ถนนเพชรบุรี,คลองส้มป่อย,ชุมชนแออัด,409,174,235
1037,ราชเทวี,ถนนเพชรบุรี,ซอยสมประสงค์ 5,ชุมชนแออัด,180,89,91
1037,ราชเทวี,ถนนเพชรบุรี,บ้านครัวตะวันตก,ชุมชนแออัด,2682,1155,1527
1037,ราชเทวี,ถนนเพชรบุรี,บ้านครัวเหนือ,ชุมชนแออัด,1975,935,1040
1037,ราชเทวี,มักกะสัน,ริมคลองสามเสน,ชุมชนแออัด,1345,644,701
1037,ราชเทวี,มักกะสัน,นิคมมักกะสัน,ชุมชนแออัด,179,79,100
1037,ราชเทวี,มักกะสัน,ริมทางรถไฟมักกะสัน,ชุมชนแออัด,1933,810,1123
1037,ราชเทวี,มักกะสัน,โรงเจมักกะสัน,ชุมชนแออัด,531,237,294
1037,ราชเทวี,มักกะสัน,หลังวัดมักกะสัน,ชุมชนแออัด,345,122,223
1024,ราษฎร์บูรณะ,ราษฎร์บูรณะ,แจงร้อน,ชุมชนแออัด,424,208,216
1024,ราษฎร์บูรณะ,ราษฎร์บูรณะ,ซอยสถาพร,ชุมชนแออัด,1426,677,749
1024,ราษฎร์บูรณะ,ราษฎร์บูรณะ,เบอร์ลี่,ชุมชนแออัด,308,148,160
1024,ราษฎร์บูรณะ,ราษฎร์บูรณะ,ร่วมใจ,ชุมชนแออัด,354,167,187
1024,ราษฎร์บูรณะ,ราษฎร์บูรณะ,วัดสน,ชุมชนแออัด,627,315,312
1024,ราษฎร์บูรณะ,ราษฎร์บูรณะ,สุขสวัสดิ์ 29,ชุมชนแออัด,1410,691,719
1024,ราษฎร์บูรณะ,ราษฎร์บูรณะ,สุขสวัสดิ์ 31,ชุมชนแออัด,381,188,193
1024,ราษฎร์บูรณะ,ราษฎร์บูรณะ,สุขสวัสดิ์ 60,ชุมชนแออัด,291,134,157
1024,ราษฎร์บูรณะ,ราษฎร์บูรณะ,หมู่ 7 ราษฎร์บูรณะ,ชุมชนแออัด,1390,649,741
1024,ราษฎร์บูรณะ,ราษฎร์บูรณะ,บุญมาก,ชุมชนแออัด,370,174,196
1024,ราษฎร์บูรณะ,ราษฎร์บูรณะ,บูรณะสุดเขต,ชุมชนแออัด,416,206,210
1024,ราษฎร์บูรณะ,ราษฎร์บูรณะ,ซอยรุ่งเรือง,ชุมชนแออัด,855,386,469
1024,ราษฎร์บูรณะ,ราษฎร์บูรณะ,หมู่ 3 ราษฎร์บูรณะ,ชุมชนแออัด,546,250,296
1024,ราษฎร์บูรณะ,ราษฎร์บูรณะ,ราษฎร์บูรณะ 39,ชุมชนเมือง,215,98,117
1024,ราษฎร์บูรณะ,ราษฎร์บูรณะ,ตึก 60 ปี,ชุมชนเมือง,305,137,168
1024,ราษฎร์บูรณะ,ราษฎร์บูรณะ,ซอยสุขสวัสดิ์ 58,ชุมชนแออัด,1505,732,773
1024,ราษฎร์บูรณะ,บางปะกอก,ซอยหมอผึ้งอุทิศ,ชุมชนแออัด,1023,507,516
1024,ราษฎร์บูรณะ,บางปะกอก,ประคองมิตร,ชุมชนแออัด,714,327,387
1024,ราษฎร์บูรณะ,บางปะกอก,มิ่งประชา,ชุมชนแออัด,229,112,117
1024,ราษฎร์บูรณะ,บางปะกอก,รวมน้ำใจ,ชุมชนแออัด,641,311,330
1024,ราษฎร์บูรณะ,บางปะกอก,สุขสวัสดิ์ 42,ชุมชนแออัด,430,190,240
1024,ราษฎร์บูรณะ,บางปะกอก,อนามัย,ชุมชนแออัด,209,102,107
1024,ราษฎร์บูรณะ,บางปะกอก,รัตนจีนะ,ชุมชนแออัด,846,413,433
1024,ราษฎร์บูรณะ,บางปะกอก,ศาลาร่วมใจพัฒนา,ชุมชนแออัด,441,220,221
1024,ราษฎร์บูรณะ,บางปะกอก,สมบูรณ์ทรัพย์,ชุมชนแออัด,220,116,104
1024,ราษฎร์บูรณะ,บางปะกอก,สุขสวัสดิ์ 9,ชุมชนแออัด,166,88,78
1024,ราษฎร์บูรณะ,บางปะกอก,สุขสวัสดิ์ 36,ชุมชนแออัด,217,110,107
1024,ราษฎร์บูรณะ,บางปะกอก,รุ่งอรุณ,ชุมชนแออัด,471,221,250
1011,ลาดกระบัง,ลาดกระบัง,ซอยธรรมนูญ,ชุมชนเมือง,595,245,350
1011,ลาดกระบัง,ลาดกระบัง,ประชาร่วมใจ (ตลาดสหกรณ์),ชุมชนเมือง,1833,882,951
1011,ลาดกระบัง,ลาดกระบัง,ร่วมใจพัฒนา,ชุมชนเมือง,1087,486,601
1011,ลาดกระบัง,ลาดกระบัง,วัดสังฆราชา,ชุมชนเมือง,1230,585,645
1011,ลาดกระบัง,ลาดกระบัง,หมู่บ้านลานบุญ,ชุมชนเมือง,461,207,254
1011,ลาดกระบัง,ลาดกระบัง,หลวงพรต-ท่านเลี่ยม,ชุมชนแออัด,480,190,290
1011,ลาดกระบัง,ลาดกระบัง,หลังวัดลานบุญ,ชุมชนเมือง,1140,528,612
1011,ลาดกระบัง,ลาดกระบัง,หมู่บ้านเคหะนคร 2,ชุมชนเมือง,3639,1687,1952
1011,ลาดกระบัง,ลาดกระบัง,มิตรปลูกศรัทธา,ชุมชนเมือง,1391,694,697
1011,ลาดกระบัง,ลาดกระบัง,หมู่บ้านสมนึก,ชุมชนเมือง,621,213,408
1011,ลาดกระบัง,ลาดกระบัง,เทอดศาสนา,ชุมชนเมือง,353,170,183
1011,ลาดกระบัง,ลาดกระบัง,ทวีปัญญารักษ์,ชุมชนเมือง,630,293,337
1011,ลาดกระบัง,ลาดกระบัง,รุ่งเรืองพัฒนา,ชุมชนเมือง,410,195,215
1011,ลาดกระบัง,ลาดกระบัง,ประชาทร,ชุมชนชานเมือง,373,182,191
1011,ลาดกระบัง,คลองสองต้นนุ่น,จิตรา,ชุมชนชานเมือง,687,307,380
1011,ลาดกระบัง,คลองสองต้นนุ่น,ฟื้นนครร่มเกล้า ระยะ 1 โซน 7,ชุมชนเมือง,1841,798,1043
1011,ลาดกระบัง,คลองสองต้นนุ่น,ฟื้นนครร่มเกล้า ระยะ 2 โซน 9,ชุมชนเมือง,1932,951,981
1011,ลาดกระบัง,คลองสองต้นนุ่น,ฟื้นนครร่มเกล้า ระยะ 3 โซน 8,ชุมชนเมือง,2775,1330,1445
1011,ลาดกระบัง,คลองสองต้นนุ่น,ฟื้นนครร่มเกล้า ระยะ 4 โซน 10,ชุมชนเมือง,1746,989,757
1011,ลาดกระบัง,คลองสองต้นนุ่น,ร่มเกล้า 1,ชุมชนชานเมือง,1560,913,647
1011,ลาดกระบัง,คลองสองต้นนุ่น,น่าฟีอะฮ์ลำนายโส,ชุมชนชานเมือง,721,343,378
1011,ลาดกระบัง,คลองสองต้นนุ่น,มิตรประชาร่วมใจฟื้นนครร่มเกล้า ระยะ 6 โซน 12,ชุมชนเมือง,1292,547,745
1011,ลาดกระบัง,คลองสองต้นนุ่น,มิตรสามัคคีฟื้นนครร่มเกล้าระยะ 5 โซน 11,ชุมชนเมือง,2084,830,1254
1011,ลาดกระบัง,คลองสองต้นนุ่น,เคหะร่มเกล้า โซน 1,ชุมชนเมือง,1482,720,762
1011,ลาดกระบัง,คลองสองต้นนุ่น,เคหะร่มเกล้า โซน 2,ชุมชนเมือง,2900,1259,1641
1011,ลาดกระบัง,คลองสองต้นนุ่น,เคหะร่มเกล้า โซน 3,ชุมชนเมือง,679,332,347
1011,ลาดกระบัง,คลองสองต้นนุ่น,เคหะร่มเกล้า โซน 4,ชุมชนเมือง,1677,781,896
1011,ลาดกระบัง,คลองสองต้นนุ่น,เคหะร่มเกล้า โซน 6,ชุมชนเมือง,1769,686,1083
1011,ลาดกระบัง,คลองสองต้นนุ่น,เคหะร่มเกล้า โซน 5,ชุมชนเมือง,1091,511,580
1011,ลาดกระบัง,คลองสองต้นนุ่น,เคหะร่มเกล้า โซนหลังคาขาว,ชุมชนเมือง,648,303,345
1011,ลาดกระบัง,คลองสองต้นนุ่น,เคหะร่มเกล้า โซนหลังคาเขียว,ชุมชนเมือง,1011,482,529
1011,ลาดกระบัง,คลองสองต้นนุ่น,เคหะร่มเกล้า โซนหลังคาแดง,ชุมชนเมือง,2704,1381,1323
1011,ลาดกระบัง,คลองสองต้นนุ่น,เคหะชุมชนร่มเกล้าแฟลตคลองสองต้นนุ่น (แฟลต 11 หลัง),ชุมชนอาคารสูง,4330,1846,2484
1011,ลาดกระบัง,คลองสองต้นนุ่น,ริมคลองลาดบัวขาว หมู่ 3,ชุมชนชานเมือง,589,270,319
1011,ลาดกระบัง,คลองสองต้นนุ่น,ลาดบัวขาวพัฒนา,ชุมชนชานเมือง,600,200,400
1011,ลาดกระบัง,คลองสองต้นนุ่น,คลองหนึ่ง,ชุมชนชานเมือง,1222,539,683
1011,ลาดกระบัง,คลองสองต้นนุ่น,รักสามัคคี,ชุมชนชานเมือง,635,376,259
1011,ลาดกระบัง,คลองสองต้นนุ่น,คลองสองร่วมใจพัฒนา,ชุมชนชานเมือง,724,398,326
1011,ลาดกระบัง,คลองสามประเวศ,ศิลาภิรัติอุปถัมภ์,ชุมชนชานเมือง,1108,454,654
1011,ลาดกระบัง,คลองสามประเวศ,บำรุงรื่น,ชุมชนชานเมือง,767,345,422
1011,ลาดกระบัง,คลองสามประเวศ,สองฝั่งคลอง,ชุมชนชานเมือง,1105,433,672
1011,ลาดกระบัง,คลองสามประเวศ,หมู่ 4 คลองสามประเวศ,ชุมชนชานเมือง,1222,497,725
1011,ลาดกระบัง,คลองสามประเวศ,พุทธ-มุสลิมสามัคคี ร่มเกล้า 50,ชุมชนชานเมือง,548,236,312
1011,ลาดกระบัง,ลำปลาทิว,บึงบัว,ชุมชนชานเมือง,2268,1056,1212
1011,ลาดกระบัง,ลำปลาทิว,หมู่บ้านพัฒนาทิพพาวาส,ชุมชนเมือง,2535,1188,1347
1011,ลาดกระบัง,ลำปลาทิว,หมู่บ้านพัฒนา หมู่ที่ 11 (ชุมชนคลองเจ็ก),ชุมชนชานเมือง,525,255,270
1011,ลาดกระบัง,ลำปลาทิว,หมู่บ้านพัฒนา หมู่ที่ 12,ชุมชนชานเมือง,194,67,127
1011,ลาดกระบัง,ลำปลาทิว,หมู่บ้านพัฒนา หมู่ที่ 13 (ชุมชนลำคูเวียง),ชุมชนชานเมือง,215,107,108
1011,ลาดกระบัง,ลำปลาทิว,มิตรสัมพันธ์หมู่ 9 ลำปลาทิว,ชุมชนเมือง,2455,1223,1232
1011,ลาดกระบัง,ลำปลาทิว,หมู่บ้านทิวไผ่พัฒนา หมู่ 9,ชุมชนเมือง,1568,624,944
1011,ลาดกระบัง,ลำปลาทิว,ลำพุทรา,ชุมชนชานเมือง,1179,522,657
1011,ลาดกระบัง,ลำปลาทิว,ริมคลองลำปลาทิว,ชุมชนชานเมือง,684,301,383
1011,ลาดกระบัง,ทับยาว,มาเรียลัย,ชุมชนเมือง,1832,1015,817
1011,ลาดกระบัง,ทับยาว,วัดพลมานีย์,ชุมชนเมือง,1654,789,865
1011,ลาดกระบัง,ทับยาว,วัดสุทธาโภชน์สุนทรอุปถัมภ์,ชุมชนชานเมือง,1302,658,644
1011,ลาดกระบัง,ทับยาว,สุทธาวาส หมู่ที่ 7,ชุมชนชานเมือง,830,420,410
1011,ลาดกระบัง,ทับยาว,เลียบคลองมอญ หมู่ที่ 6,ชุมชนชานเมือง,1250,440,810
1011,ลาดกระบัง,ทับยาว,นำไกร หมู่ที่ 9 ทับยาว,ชุมชนชานเมือง,1350,580,770
1011,ลาดกระบัง,ทับยาว,บ้านทับยาว,ชุมชนชานเมือง,1707,850,857
1011,ลาดกระบัง,ทับยาว,ประชาอุทิศ,ชุมชนชานเมือง,690,318,372
1011,ลาดกระบัง,ทับยาว,ทิวสนร่วมจิตมณียา,ชุมชนเมือง,500,200,300
1011,ลาดกระบัง,ขุมทอง,วัดราชโกษา,ชุมชนชานเมือง,1775,878,897
1011,ลาดกระบัง,ขุมทอง,ดารุลมุกีมอุปถัมภ์,ชุมชนชานเมือง,996,447,549
1011,ลาดกระบัง,ขุมทอง,ซีรอตุ้ลญันนะห์,ชุมชนชานเมือง,224,99,125
1011,ลาดกระบัง,ขุมทอง,คลองตาสอน,ชุมชนชานเมือง,347,150,197
1011,ลาดกระบัง,ขุมทอง,ม่านารุ้ลฮุ่ดา,ชุมชนชานเมือง,764,378,386
1038,ลาดพร้าว,ลาดพร้าว,ซอยนกแก้วน้อย 1-2,ชุมชนแออัด,845,406,439
1038,ลาดพร้าว,ลาดพร้าว,ซอยโรงน้ำแข็ง,ชุมชนแออัด,794,388,406
1038,ลาดพร้าว,ลาดพร้าว,สันติสุข,ชุมชนแออัด,362,172,190
1038,ลาดพร้าว,ลาดพร้าว,สุขทรัพย์,ชุมชนแออัด,482,236,246
1038,ลาดพร้าว,ลาดพร้าว,"หมู่บ้านพัฒนาหมู่ 1,5",ชุมชนชานเมือง,221,92,129
1038,ลาดพร้าว,ลาดพร้าว,หมู่บ้านร่วมใจพัฒนา,ชุมชนเมือง,516,233,283
1038,ลาดพร้าว,ลาดพร้าว,หมู่บ้านเรือนทอง 2,ชุมชนเมือง,198,82,116
1038,ลาดพร้าว,ลาดพร้าว,หมู่บ้านเลิศอุบล 4,ชุมชนเมือง,628,237,391
1038,ลาดพร้าว,ลาดพร้าว,หมู่บ้านสังสิทธิ์,ชุมชนเมือง,1041,457,584
1038,ลาดพร้าว,ลาดพร้าว,หมู่บ้านโอษธิศ 2,ชุมชนเมือง,525,238,287
1038,ลาดพร้าว,ลาดพร้าว,หมู่บ้านพูนศิริ,ชุมชนเมือง,1134,514,620
1038,ลาดพร้าว,ลาดพร้าว,หมู่บ้าน ซ. อมรพันธ์ 9,ชุมชนเมือง,3262,1438,1824
1038,ลาดพร้าว,ลาดพร้าว,หมู่บ้านสมิทธิโชติ,ชุมชนเมือง,394,175,219
1038,ลาดพร้าว,ลาดพร้าว,หมู่บ้านเรือนทอง 3,ชุมชนเมือง,326,147,179
1038,ลาดพร้าว,ลาดพร้าว,หมู่บ้านเอื้อประชา,ชุมชนเมือง,327,125,202
1038,ลาดพร้าว,ลาดพร้าว,หมู่บ้านเฟรนชิพ,ชุมชนเมือง,1613,774,839
1038,ลาดพร้าว,ลาดพร้าว,หมู่บ้านรวมโชค,ชุมชนเมือง,3946,1806,2140
1038,ลาดพร้าว,ลาดพร้าว,อาคารสงเคราะห์ฯ ลาดพร้าว 71,ชุมชนอาคารสูง,186,107,79
1038,ลาดพร้าว,ลาดพร้าว,หมู่บ้านมหาลาภ,ชุมชนเมือง,498,235,263
1038,ลาดพร้าว,ลาดพร้าว,พุ่มโพธิ์กลาง,ชุมชนเมือง,484,218,266
1038,ลาดพร้าว,ลาดพร้าว,หมู่บ้านเพิ่มพูน,ชุมชนเมือง,299,138,161
1038,ลาดพร้าว,ลาดพร้าว,หมู่บ้านธนะธานี,ชุมชนเมือง,243,116,127
1038,ลาดพร้าว,ลาดพร้าว,หมู่บ้านเจริญสุขนิเวศน์ 1,ชุมชนเมือง,144,61,83
1038,ลาดพร้าว,ลาดพร้าว,หมู่บ้านราณี 5,ชุมชนเมือง,884,403,481
1038,ลาดพร้าว,ลาดพร้าว,หมู่บ้านอยู่เจริญ 3,ชุมชนเมือง,298,132,166
1038,ลาดพร้าว,ลาดพร้าว,หมู่บ้านลาดพร้าววิลเลจ,ชุมชนเมือง,764,359,405
1038,ลาดพร้าว,จรเข้บัว,หมู่บ้านเจริญสุข 4,ชุมชนเมือง,540,225,315
1038,ลาดพร้าว,จรเข้บัว,หมู่บ้านเนียมกล่ำสามัคคี,ชุมชนชานเมือง,1487,684,803
1038,ลาดพร้าว,จรเข้บัว,หมู่บ้านธันยกานต์ มัยลาภ,ชุมชนเมือง,399,174,225
1038,ลาดพร้าว,จรเข้บัว,หมู่บ้านเพชรหทัย,ชุมชนเมือง,179,78,101
1038,ลาดพร้าว,จรเข้บัว,หมู่บ้านเสนานิเวศน์ โครงการ 1,ชุมชนเมือง,5247,2316,2931
1038,ลาดพร้าว,จรเข้บัว,หมู่บ้านราณี 2,ชุมชนเมือง,762,323,439
1038,ลาดพร้าว,จรเข้บัว,ซอยลาดปลาเค้า 24,ชุมชนเมือง,584,279,305
1038,ลาดพร้าว,จรเข้บัว,หมู่บ้านเสนานิเวศน์ โครงการ 2,ชุมชนเมือง,2970,1348,1622
1038,ลาดพร้าว,จรเข้บัว,หมู่บ้านเรือนแก้ว,ชุมชนเมือง,373,170,203
1038,ลาดพร้าว,จรเข้บัว,หมู่บ้านจิรัฐติกร 7,ชุมชนเมือง,570,233,337
1045,วังทองหลาง,วังทองหลาง,ลาดพร้าว 80 แยก 11,ชุมชนแออัด,906,444,462
1045,วังทองหลาง,วังทองหลาง,ลาดพร้าว 64,ชุมชนเมือง,654,272,382
1045,วังทองหลาง,วังทองหลาง,ริมคลองลาดพร้าว,ชุมชนแออัด,746,372,374
1045,วังทองหลาง,คลองเจ้าคุณสิงห์,จันทราสุข,ชุมชนแออัด,1384,695,689
1045,วังทองหลาง,คลองเจ้าคุณสิงห์,ลาดพร้าว 91,ชุมชนแออัด,769,370,399
1045,วังทองหลาง,คลองเจ้าคุณสิงห์,หมู่บ้านอยู่เจริญ ซอยลาดพร้าว 101,ชุมชนเมือง,1107,488,619
1045,วังทองหลาง,พลับพลา,ไดร์ฟอิน,ชุมชนแออัด,243,103,140
1045,วังทองหลาง,พลับพลา,ทรัพย์สินเก่า,ชุมชนแออัด,2970,891,2079
1045,วังทองหลาง,พลับพลา,ทรัพย์สินใหม่,ชุมชนแออัด,1378,617,761
1045,วังทองหลาง,พลับพลา,รามคำแหง 53,ชุมชนแออัด,805,376,429
1045,วังทองหลาง,พลับพลา,รุ่งมณีพัฒนา,ชุมชนแออัด,1607,755,852
1045,วังทองหลาง,พลับพลา,วัดเทพลีลา,ชุมชนแออัด,814,404,410
1045,วังทองหลาง,พลับพลา,น้อมเกล้า,ชุมชนแออัด,1200,465,735
1045,วังทองหลาง,พลับพลา,9 พัฒนา,ชุมชนแออัด,174,79,95
1045,วังทองหลาง,พลับพลา,หมู่บ้านพลับพลา,ชุมชนเมือง,772,388,384
1045,วังทองหลาง,พลับพลา,สันประเสริฐ,ชุมชนแออัด,1140,550,590
1045,วังทองหลาง,พลับพลา,สุเหร่าดอนสะแก,ชุมชนแออัด,775,359,416
1045,วังทองหลาง,พลับพลา,ร่วมสามัคคี,ชุมชนแออัด,512,205,307
1045,วังทองหลาง,พลับพลา,คลองพลับพลา,ชุมชนแออัด,1167,545,622
1039,วัฒนา,คลองเตยเหนือ,เฉลิมอนุสรณ์,ชุมชนแออัด,221,118,103
1039,วัฒนา,คลองเตยเหนือ,รื่นฤดี,ชุมชนแออัด,243,113,130
1039,วัฒนา,คลองตันเหนือ,ข้างสะพานคลองตัน,ชุมชนแออัด,264,128,136
1039,วัฒนา,คลองตันเหนือ,นวลจิตร,ชุมชนแออัด,2103,1015,1088
1039,วัฒนา,คลองตันเหนือ,สุเหร่าบ้านดอน,ชุมชนแออัด,3651,1773,1878
1039,วัฒนา,คลองตันเหนือ,เกษมสำราญ,ชุมชนเมือง,338,162,176
1039,วัฒนา,คลองตันเหนือ,แจ่มจันทร์,ชุมชนแออัด,399,187,212
1039,วัฒนา,คลองตันเหนือ,ชวาลา,ชุมชนแออัด,632,311,321
1039,วัฒนา,คลองตันเหนือ,พัฒนาบ้านสามอิน,ชุมชนแออัด,1348,619,729
1039,วัฒนา,คลองตันเหนือ,หลังสถานีตำรวจนครบาลทองหล่อ,ชุมชนแออัด,247,113,134
1039,วัฒนา,คลองตันเหนือ,คลองเป้ง (ลีลานุช),ชุมชนแออัด,302,159,143
1039,วัฒนา,พระโขนงเหนือ,ข้าวธนาคารศรีนคร (มีสุวรรณ 3),ชุมชนแออัด,740,374,366
1039,วัฒนา,พระโขนงเหนือ,สุเหร่าบางมะเขือ,ชุมชนแออัด,1396,670,726
1039,วัฒนา,พระโขนงเหนือ,หมู่บ้านพิบูลเวศม์,ชุมชนเมือง,785,367,418
1039,วัฒนา,พระโขนงเหนือ,ศาลาลอย,ชุมชนแออัด,444,213,231
1039,วัฒนา,พระโขนงเหนือ,มีสุวรรณ 2,ชุมชนแออัด,151,68,83
1034,สวนหลวง,สวนหลวง,ประสาทศีล,ชุมชนเมือง,1492,768,724
1034,สวนหลวง,สวนหลวง,ร่วมพัฒนาบ้านป่า,ชุมชนเมือง,2111,1069,1042
1034,สวนหลวง,สวนหลวง,แสงสันติ,ชุมชนเมือง,151,65,86
1034,สวนหลวง,สวนหลวง,แหลมทองพัฒนา,ชุมชนเมือง,1369,729,640
1034,สวนหลวง,สวนหลวง,อัลกุ๊บรอ,ชุมชนเมือง,637,266,371
1034,สวนหลวง,สวนหลวง,คลองจวน,ชุมชนเมือง,1191,550,641
1034,สวนหลวง,สวนหลวง,มุสลิมพัฒนาบ้านป่า,ชุมชนเมือง,1680,791,889
1034,สวนหลวง,สวนหลวง,คลองสะแก,ชุมชนเมือง,798,398,400
1034,สวนหลวง,สวนหลวง,หมู่บ้านฮอลลีวู้ด,ชุมชนเมือง,682,282,400
1034,สวนหลวง,สวนหลวง,เจริญพัฒนา,ชุมชนเมือง,1906,910,996
1034,สวนหลวง,สวนหลวง,หมู่บ้านเกษมสันต์ 2,ชุมชนเมือง,498,187,311
1034,สวนหลวง,สวนหลวง,พัฒนาริมคลองบ้านป่า,ชุมชนเมือง,777,385,392
1034,สวนหลวง,สวนหลวง,หมู่บ้านเกษรา-ฐิติพร,ชุมชนเมือง,859,360,499
1034,สวนหลวง,สวนหลวง,พัฒนาคลองสะแก,ชุมชนเมือง,918,450,468
1034,สวนหลวง,สวนหลวง,คลองเจ็ดขนัด,ชุมชนเมือง,296,132,164
1034,สวนหลวง,สวนหลวง,สวนหลวงก้าวหน้า,ชุมชนเมือง,884,412,472
1034,สวนหลวง,สวนหลวง,หมู่บ้านเกษมสันต์ 1,ชุมชนเมือง,200,90,110
1034,สวนหลวง,สวนหลวง,สมานมิตรพัฒนา,ชุมชนเมือง,499,223,276
1034,สวนหลวง,สวนหลวง,มิตรไมตรี,ชุมชนเมือง,493,211,282
1034,สวนหลวง,อ่อนนุช,ดาราฉาย,ชุมชนเมือง,695,321,374
1034,สวนหลวง,อ่อนนุช,ดารุ้ลอามีน,ชุมชนเมือง,256,118,138
1034,สวนหลวง,อ่อนนุช,โมราวรรณ 1,ชุมชนเมือง,1512,673,839
1034,สวนหลวง,อ่อนนุช,โมราวรรณ 2,ชุมชนเมือง,1329,626,703
1034,สวนหลวง,อ่อนนุช,ร่วมใจ,ชุมชนเมือง,649,345,304
1034,สวนหลวง,อ่อนนุช,สะและน้อย,ชุมชนเมือง,1805,733,1072
1034,สวนหลวง,อ่อนนุช,หลังวัดปากบ่อ,ชุมชนเมือง,4426,2208,2218
1034,สวนหลวง,อ่อนนุช,หัวป่า,ชุมชนเมือง,1635,625,1010
1034,สวนหลวง,อ่อนนุช,เอื้ออารีย์,ชุมชนเมือง,1561,738,823
1034,สวนหลวง,อ่อนนุช,ภูมิสุข,ชุมชนเมือง,324,148,176
1034,สวนหลวง,อ่อนนุช,พร้อมใจ,ชุมชนเมือง,165,72,93
1034,สวนหลวง,อ่อนนุช,วัดใต้,ชุมชนแออัด,697,400,297
1034,สวนหลวง,อ่อนนุช,โรงหวาย,ชุมชนแออัด,376,182,194
1034,สวนหลวง,อ่อนนุช,มหาพลสัมพันธ์,ชุมชนเมือง,469,238,231
1034,สวนหลวง,อ่อนนุช,วัดทองเจ้าพัฒนา,ชุมชนเมือง,571,260,311
1034,สวนหลวง,อ่อนนุช,หมู่บ้านอ่อนนุชทาวน์เฮ้าส์ 1,ชุมชนเมือง,637,266,371
1034,สวนหลวง,พัฒนาการ,ธรรมานุรักษ์,ชุมชนเมือง,539,250,289
1034,สวนหลวง,พัฒนาการ,นาคภาษิต,ชุมชนเมือง,1378,758,620
1034,สวนหลวง,พัฒนาการ,วิเศษสุข,ชุมชนเมือง,876,426,450
1034,สวนหลวง,พัฒนาการ,หลังสถานีรถไฟหัวหมาก,ชุมชนเมือง,1230,680,550
1034,สวนหลวง,พัฒนาการ,หัวหมากเกาะกลาง,ชุมชนเมือง,771,369,402
1034,สวนหลวง,พัฒนาการ,อัลเอี๊ยะติซอม,ชุมชนเมือง,2015,942,1073
1034,สวนหลวง,พัฒนาการ,หมู่บ้านเมืองทอง 2/3,ชุมชนเมือง,4106,2154,1952
1034,สวนหลวง,พัฒนาการ,คลองหัวหมาก,ชุมชนเมือง,128,58,70
1034,สวนหลวง,พัฒนาการ,ริมคลองหัวหมากใหญ่,ชุมชนเมือง,1017,513,504
1034,สวนหลวง,พัฒนาการ,ถนนพระราม 9 พัฒนา,ชุมชนเมือง,231,115,116
1044,สะพานสูง,สะพานสูง,หมู่ 11 สะพานสูง (เกาะดอน),ชุมชนแออัด,837,423,414
1044,สะพานสูง,สะพานสูง,แสงมณี,ชุมชนชานเมือง,536,271,265
1044,สะพานสูง,สะพานสูง,คลองเจ็กพัฒนา,ชุมชนชานเมือง,431,284,147
1044,สะพานสูง,สะพานสูง,ฮิดายะห์พัฒนา,ชุมชนชานเมือง,356,175,181
1044,สะพานสูง,สะพานสูง,วัดลาดบัวขาว (ราชโยธา),ชุมชนชานเมือง,471,226,245
1044,สะพานสูง,สะพานสูง,คลองบ้านม้าหมู่ 10,ชุมชนชานเมือง,241,80,161
1044,สะพานสูง,ราษฎร์พัฒนา,หัวบ้านคลองบางเลา,ชุมชนชานเมือง,494,244,250
1044,สะพานสูง,ทับช้าง,หมู่บ้านนักกีฬาแหลมทอง,ชุมชนเมือง,9366,4174,5192
1044,สะพานสูง,ราษฎร์พัฒนา,มัสยิดย่ามีลุ้ลอิบาดะห์ (ลาดบัวขาว),ชุมชนแออัด,1001,500,501
1044,สะพานสูง,ราษฎร์พัฒนา,แสงธรรมคลองมณี,ชุมชนชานเมือง,564,250,314
1044,สะพานสูง,ราษฎร์พัฒนา,หมู่บ้านเคหะนคร,ชุมชนเมือง,5880,2710,3170
1044,สะพานสูง,ราษฎร์พัฒนา,หลอแหลคลองใหญ่,ชุมชนชานเมือง,612,290,322
1044,สะพานสูง,ราษฎร์พัฒนา,สามแยกคลองหลอแหล,ชุมชนชานเมือง,1301,629,672
1044,สะพานสูง,ราษฎร์พัฒนา,วังหนับอุทิศ,ชุมชนแออัด,767,369,398
1044,สะพานสูง,ราษฎร์พัฒนา,ร่วมพัฒนาหมู่ 9 สะพานสูง,ชุมชนชานเมือง,348,177,171
1044,สะพานสูง,ราษฎร์พัฒนา,หมู่ 8 สะพานสูง (สุเหร่าซีรอ),ชุมชนชานเมือง,1130,517,613
1044,สะพานสูง,ราษฎร์พัฒนา,หลอแหลสายกลาง,ชุมชนชานเมือง,548,267,281
1044,สะพานสูง,ทับช้าง,คลองทับช้างล่าง,ชุมชนชานเมือง,673,309,364
1044,สะพานสูง,ทับช้าง,ซาอาดะห์,ชุมชนแออัด,423,204,219
1044,สะพานสูง,ทับช้าง,ทับช้างคลองบน,ชุมชนชานเมือง,1229,606,623
1044,สะพานสูง,ทับช้าง,ทับช้างนาลุ่ม,ชุมชนชานเมือง,853,418,435
1044,สะพานสูง,ทับช้าง,บ้านม้าเกาะบน,ชุมชนชานเมือง,427,211,216
1044,สะพานสูง,ทับช้าง,บ้านม้าเกาะล่าง,ชุมชนชานเมือง,611,315,296
1044,สะพานสูง,ทับช้าง,คลองแม่จันทร์,ชุมชนชานเมือง,237,130,107
1044,สะพานสูง,ทับช้าง,มุสลิมสัมพันธ์,ชุมชนชานเมือง,204,98,106
1044,สะพานสูง,ทับช้าง,สวนนกพัฒนา,ชุมชนชานเมือง,401,185,216
1044,สะพานสูง,ทับช้าง,สะพานสูงหมู่ 14 พัฒนา,ชุมชนชานเมือง,487,242,245
1044,สะพานสูง,ทับช้าง,รวมใจพัฒนาวังใหญ่,ชุมชนเมือง,444,227,217
1044,สะพานสูง,ทับช้าง,วังใหญ่พัฒนา,ชุมชนเมือง,1128,573,555
1013,สัมพันธวงศ์,จักรวรรดิ,มิตรชัยภูมิ,ชุมชนเมือง,114,55,59
1013,สัมพันธวงศ์,จักรวรรดิ,สะพานหัน,ชุมชนเมือง,297,146,151
1013,สัมพันธวงศ์,จักรวรรดิ,อิสรานุภาพ,ชุมชนเมือง,218,58,160
1013,สัมพันธวงศ์,จักรวรรดิ,ริมคลองโอ่งอ่าง,ชุมชนเมือง,310,139,171
1013,สัมพันธวงศ์,จักรวรรดิ,ภิรมย์,ชุมชนเมือง,375,180,195
1013,สัมพันธวงศ์,สัมพันธวงศ์,พาดสาย,ชุมชนเมือง,222,100,122
1013,สัมพันธวงศ์,สัมพันธวงศ์,พิพากษา,ชุมชนเมือง,463,202,261
1013,สัมพันธวงศ์,สัมพันธวงศ์,กุศลสามัคคี,ชุมชนเมือง,209,98,111
1013,สัมพันธวงศ์,สัมพันธวงศ์,เล่งบ้วยเอี๊ยะ,ชุมชนเมือง,472,247,225
1013,สัมพันธวงศ์,ตลาดน้อย,โปลิศสภา,ชุมชนเมือง,834,397,437
1013,สัมพันธวงศ์,ตลาดน้อย,ตลาดน้อย,ชุมชนเมือง,243,110,133
1013,สัมพันธวงศ์,ตลาดน้อย,จงสวัสดิ์,ชุมชนเมือง,128,48,80
1013,สัมพันธวงศ์,ตลาดน้อย,วานิชสัมพันธ์,ชุมชนเมือง,168,72,96
1013,สัมพันธวงศ์,ตลาดน้อย,โชฎึก,ชุมชนเมือง,289,136,153
1028,สาทร,ทุ่งวัดดอน,กิ่งจันทร์,ชุมชนแออัด,312,166,146
1028,สาทร,ทุ่งวัดดอน,กุศลทอง,ชุมชนแออัด,1382,670,712
1028,สาทร,ทุ่งวัดดอน,มิตรสามัคคี,ชุมชนแออัด,217,110,107
1028,สาทร,ทุ่งวัดดอน,ร่วมพัฒนาวรพจน์ 1,ชุมชนแออัด,1052,412,640
1028,สาทร,ทุ่งวัดดอน,วรรัตน์สัมพันธ์,ชุมชนเมือง,8125,3773,4352
1028,สาทร,ทุ่งวัดดอน,วัดปรก,ชุมชนเมือง,2250,1159,1091
1028,สาทร,ทุ่งวัดดอน,แสงจันทร์ใน,ชุมชนแออัด,858,396,462
1028,สาทร,ทุ่งวัดดอน,หมู่บ้านเจริญสุขใจ,ชุมชนเมือง,1132,487,645
1028,สาทร,ทุ่งวัดดอน,หมู่บ้านจันทรานิเวศน์,ชุมชนเมือง,1045,408,637
1028,สาทร,ทุ่งวัดดอน,ชวนชื่น,ชุมชนเมือง,740,312,428
1028,สาทร,ทุ่งวัดดอน,ดอนกุศลพัฒนา,ชุมชนเมือง,1950,900,1050
1028,สาทร,ทุ่งวัดดอน,ดอนกุศลร่วมใจ,ชุมชนเมือง,560,248,312
1028,สาทร,ทุ่งวัดดอน,ท้ายซอยจันทน์ 31,ชุมชนเมือง,765,422,343
1028,สาทร,ทุ่งวัดดอน,จันทร์ร่ำรวย,ชุมชนแออัด,365,192,173
1028,สาทร,ทุ่งวัดดอน,ปู่เหลี่ยม,ชุมชนเมือง,450,212,238
1028,สาทร,ยานนาวา,เซ็นต์หลุยส์ 3,ชุมชนเมือง,272,151,121
1028,สาทร,ยานนาวา,พระยานคร,ชุมชนเมือง,377,171,206
1028,สาทร,ยานนาวา,บ้านแบบ,ชุมชนแออัด,1380,669,711
1028,สาทร,ยานนาวา,โรงน้ำแข็ง,ชุมชนเมือง,3780,1722,2058
1028,สาทร,ยานนาวา,ศรีสุริโยทัย,ชุมชนเมือง,738,360,378
1028,สาทร,ทุ่งมหาเมฆ,ซอยพัฒนสิน,ชุมชนเมือง,980,482,498
1028,สาทร,ทุ่งมหาเมฆ,หน้าสมาคมธรรมศาสตร์,ชุมชนแออัด,761,374,387
1028,สาทร,ทุ่งมหาเมฆ,บ้านมั่นคงสวนพลู,ชุมชนเมือง,853,432,421
1028,สาทร,ทุ่งมหาเมฆ,บ้านเอื้ออาทรสวนพลูพัฒนา,ชุมชนอาคารสูง,1733,709,1024
1042,สายไหม,สายไหม,หมู่บ้านมัณฑวรรณ,ชุมชนเมือง,420,192,228
1042,สายไหม,สายไหม,หมู่บ้านเก้าแสนห้าสัมพันธ์,ชุมชนเมือง,1036,496,540
1042,สายไหม,สายไหม,หมู่บ้านทัพฟ้า,ชุมชนเมือง,514,211,303
1042,สายไหม,สายไหม,หมู่บ้านเทพทิพย์นิเวศน์,ชุมชนเมือง,460,209,251
1042,สายไหม,สายไหม,หมู่บ้านพลายรัตนะ,ชุมชนเมือง,676,308,368
1042,สายไหม,สายไหม,หมู่บ้านอัมรินทร์นิเวศน์ 3 ผัง 1 ม.5,ชุมชนเมือง,1807,845,962
1042,สายไหม,สายไหม,หมู่บ้านอัมรินทร์นิเวศน์ 3 ผัง 2 ม.1,ชุมชนเมือง,1235,584,651
1042,สายไหม,สายไหม,หมู่บ้านแอนเน็กซ์,ชุมชนเมือง,14781,6889,7892
1042,สายไหม,สายไหม,หมู่บ้านเจริญวงศ์,ชุมชนเมือง,283,141,142
1042,สายไหม,สายไหม,หมู่บ้านอัมรินทร์นิเวศน์ 3 ผัง 4,ชุมชนเมือง,3349,1644,1705
1042,สายไหม,สายไหม,หมู่บ้านชลลดา,ชุมชนเมือง,1991,897,1094
1042,สายไหม,สายไหม,หมู่บ้านอัมรินทร์นิเวศน์ 3 ผัง 3,ชุมชนเมือง,1336,720,616
1042,สายไหม,สายไหม,หมู่บ้านสายทิพย์,ชุมชนเมือง,522,236,286
1042,สายไหม,สายไหม,หมู่บ้าน ทอส.10,ชุมชนเมือง,264,121,143
1042,สายไหม,สายไหม,หมู่บ้านศิรินคร,ชุมชนเมือง,652,307,345
1042,สายไหม,สายไหม,หมู่บ้านเลิศปิยะวรรณ,ชุมชนเมือง,301,167,134
1042,สายไหม,สายไหม,หมู่บ้านอภินคร 2000,ชุมชนเมือง,698,327,371
1042,สายไหม,สายไหม,สายไหมพัฒนา,ชุมชนชานเมือง,651,333,318
1042,สายไหม,สายไหม,หมู่บ้านซิลค์วิลเลจ,ชุมชนเมือง,1399,746,653
1042,สายไหม,สายไหม,ทองสถิตย์วิลล่า,ชุมชนเมือง,954,534,420
1042,สายไหม,สายไหม,ประชานุกูล,ชุมชนชานเมือง,1950,695,1255
1042,สายไหม,สายไหม,หมู่บ้านมนชญา 1,ชุมชนเมือง,1378,687,691
1042,สายไหม,สายไหม,หมู่บ้านสายไหม,ชุมชนเมือง,521,234,287
1042,สายไหม,สายไหม,หมู่บ้าน กม.24,ชุมชนเมือง,678,310,368
1042,สายไหม,สายไหม,หมู่บ้านอรุณวรรณ,ชุมชนเมือง,449,199,250
1042,สายไหม,สายไหม,หมู่บ้านสายไหมวิลล่า,ชุมชนเมือง,375,173,202
1042,สายไหม,สายไหม,พหลโยธิน 66 รวมใจพัฒนา,ชุมชนเมือง,195,87,108
1042,สายไหม,สายไหม,กม.25-26,ชุมชนเมือง,3039,1340,1699
1042,สายไหม,สายไหม,มารวย 1,ชุมชนเมือง,941,372,569
1042,สายไหม,ออเงิน,เคหะรัชดา-ออเงิน,ชุมชนชานเมือง,377,169,208
1042,สายไหม,ออเงิน,พรพระร่วงพัฒนา,ชุมชนชานเมือง,354,180,174
1042,สายไหม,ออเงิน,วัดหนองใหญ่,ชุมชนชานเมือง,390,215,175
1042,สายไหม,ออเงิน,สหชุมชนโครงการ 1,ชุมชนชานเมือง,192,92,100
1042,สายไหม,ออเงิน,หมู่บ้านอัมพรเพลส 2,ชุมชนเมือง,428,197,231
1042,สายไหม,ออเงิน,การเคหะชุมชนพรพระร่วงประสิทธิ์,ชุมชนอาคารสูง,1256,480,776
1042,สายไหม,ออเงิน,วัชรพล 3,ชุมชนเมือง,2276,956,1320
1042,สายไหม,ออเงิน,อัมพรเพลส 1,ชุมชนเมือง,635,259,376
1042,สายไหม,ออเงิน,หมู่บ้านริมอินทรา,ชุมชนเมือง,529,223,306
1042,สายไหม,ออเงิน,เสือใหญ่,ชุมชนเมือง,302,124,178
1042,สายไหม,ออเงิน,หมู่บ้านแสงธรรม,ชุมชนเมือง,647,318,329
1042,สายไหม,คลองถนน,หมู่ 5 กสบ.,ชุมชนแออัด,816,360,456
1042,สายไหม,คลองถนน,กรุณาพัฒนา,ชุมชนเมือง,424,180,244
1042,สายไหม,คลองถนน,ซอยทหารอากาศ,ชุมชนเมือง,640,338,302
1042,สายไหม,คลองถนน,ทองอยู่ร่วมใจ,ชุมชนเมือง,130,64,66
1042,สายไหม,คลองถนน,ทิมเรืองเวช (สะพานใหม่),ชุมชนเมือง,1108,520,588
1042,สายไหม,คลองถนน,เมตตาพหลโยธิน 50,ชุมชนเมือง,515,252,263
1042,สายไหม,คลองถนน,ร่วมใจสามัคคี,ชุมชนเมือง,1512,683,829
1042,สายไหม,คลองถนน,รวมใจสามัคคี (หนองผักชี),ชุมชนแออัด,619,289,330
1042,สายไหม,คลองถนน,วัดลุ่มเจริญศรัธา,ชุมชนเมือง,1878,851,1027
1042,สายไหม,คลองถนน,ศาลเจ้าพ่อสมบุญ,ชุมชนเมือง,790,386,404
1042,สายไหม,คลองถนน,เสนาวัฒนา,ชุมชนเมือง,1440,746,694
1042,สายไหม,คลองถนน,หมู่บ้านซื่อตรง,ชุมชนเมือง,903,402,501
1042,สายไหม,คลองถนน,หมู่บ้านพัฒนาหมู่ 1,ชุมชนแออัด,964,384,580
1042,สายไหม,คลองถนน,หมู่บ้านพัฒนาหมู่ 2,ชุมชนแออัด,1092,509,583
1042,สายไหม,คลองถนน,หมู่บ้านพัฒนาหมู่ 3,ชุมชนเมือง,503,248,255
1042,สายไหม,คลองถนน,หมู่บ้านสุขสมบูรณ์ (ซอย 50),ชุมชนเมือง,541,229,312
1042,สายไหม,คลองถนน,ดอนเมืองวิลล่า,ชุมชนเมือง,1776,804,972
1042,สายไหม,คลองถนน,เธียรสวนพัฒนา 33,ชุมชนเมือง,1497,686,811
1042,สายไหม,คลองถนน,เพิ่มสิน (ซอยถมยาสามัคคี),ชุมชนเมือง,649,276,373
1042,สายไหม,คลองถนน,หมู่บ้านเลิศอุบล,ชุมชนเมือง,823,371,452
1042,สายไหม,คลองถนน,รวมมิตรสัมพันธ์ (ซอยเธียรสวน 1),ชุมชนเมือง,839,349,490
1042,สายไหม,คลองถนน,หมู่บ้านเพิ่มสิน 1 - 2,ชุมชนเมือง,1748,808,940
1042,สายไหม,คลองถนน,เพิ่มสินทรัพย์,ชุมชนเมือง,1680,753,927
1042,สายไหม,คลองถนน,หมู่บ้านเทพนครนิเวศน์,ชุมชนเมือง,451,219,232
1042,สายไหม,คลองถนน,แม่บ้านร่วมใจพัฒนา,ชุมชนเมือง,666,313,353
1042,สายไหม,คลองถนน,หมู่บ้านณัฐกานต์,ชุมชนเมือง,1228,580,648
1042,สายไหม,คลองถนน,ใจรัก,ชุมชนเมือง,574,252,322
1042,สายไหม,คลองถนน,หมู่บ้านเกาะแก้ววิลล่า,ชุมชนเมือง,667,350,317
1042,สายไหม,คลองถนน,หมู่บ้านพัฒนา 52,ชุมชนเมือง,556,269,287
1042,สายไหม,คลองถนน,พูนทรัพย์ (ใต้สะพานโซน 4),ชุมชนเมือง,838,349,489
1042,สายไหม,คลองถนน,หมู่บ้านทองสถิตย์วิลล่า 52,ชุมชนเมือง,380,190,190
1042,สายไหม,คลองถนน,ดวงมณี,ชุมชนเมือง,943,430,513
1042,สายไหม,คลองถนน,รุ่งเรืองเฮาส์,ชุมชนเมือง,1325,563,762
1042,สายไหม,คลองถนน,หมู่บ้านอรุณนิเวศน์,ชุมชนเมือง,26,13,13
1042,สายไหม,คลองถนน,หมู่บ้านระเบียงทอง 3,ชุมชนเมือง,927,431,496
1042,สายไหม,คลองถนน,ธาราทิพย์พัฒนา,ชุมชนเมือง,591,262,329
1042,สายไหม,คลองถนน,สะพานดวงมณีพัฒนา,ชุมชนเมือง,642,325,317
1042,สายไหม,คลองถนน,สัมพันธ์สายน้ำผึ้ง,ชุมชนเมือง,644,290,354
1042,สายไหม,คลองถนน,หมู่บ้านจิตภาวรรณ 2-3,ชุมชนเมือง,1268,453,815
1023,หนองแขม,หนองแขม,จัดสรร 2,ชุมชนชานเมือง,546,257,289
1023,หนองแขม,หนองแขม,ซอยโรงงานยากันยุง,ชุมชนชานเมือง,131,57,74
1023,หนองแขม,หนองแขม,ประดิษฐ์เจริญ,ชุมชนเมือง,606,282,324
1023,หนองแขม,หนองแขม,เลียบคลองหมื่นแช่ม หมู่ 6,ชุมชนชานเมือง,393,185,208
1023,หนองแขม,หนองแขม,สวัสดิการหนองแขม,ชุมชนชานเมือง,4256,1889,2367
1023,หนองแขม,หนองแขม,สะพาน 1,ชุมชนชานเมือง,541,245,296
1023,หนองแขม,หนองแขม,สาครปานสินธุ์,ชุมชนชานเมือง,189,89,100
1023,หนองแขม,หนองแขม,หมู่ 1 หนองแขม,ชุมชนเมือง,893,485,408
1023,หนองแขม,หนองแขม,หมู่ 11 แขวงหนองแขม,ชุมชนชานเมือง,497,233,264
1023,หนองแขม,หนองแขม,หมู่บ้านกานดา,ชุมชนเมือง,757,372,385
1023,หนองแขม,หนองแขม,หมู่บ้านพุดตาน,ชุมชนเมือง,3433,1956,1477
1023,หนองแขม,หนองแขม,หรรษา 1,ชุมชนชานเมือง,2420,1132,1288
1023,หนองแขม,หนองแขม,เอี่ยมวุฒิ,ชุมชนเมือง,606,282,324
1023,หนองแขม,หนองแขม,ซอยประสิทธิ์ 4/3,ชุมชนชานเมือง,288,152,136
1023,หนองแขม,หนองแขม,ซอยสถิตย์,ชุมชนชานเมือง,214,111,103
1023,หนองแขม,หนองแขม,ตลาดหนองแขม,ชุมชนชานเมือง,314,149,165
1023,หนองแขม,หนองแขม,ศิริธร,ชุมชนชานเมือง,447,211,236
1023,หนองแขม,หนองแขม,หมู่บ้านวังทอง,ชุมชนเมือง,1424,611,813
1023,หนองแขม,หนองแขม,ดงรัก,ชุมชนชานเมือง,980,486,494
1023,หนองแขม,หนองแขม,เลียบคลองตาปลั่ง,ชุมชนชานเมือง,887,455,432
1023,หนองแขม,หนองแขม,ศาลเจ้าแม่กวนอิม,ชุมชนชานเมือง,1284,640,644
1023,หนองแขม,หนองแขม,หรรษา 79,ชุมชนเมือง,1195,585,610
1023,หนองแขม,หนองแขม,ธนวัฑฒ์,ชุมชนเมือง,234,90,144
1023,หนองแขม,หนองแขม,หมุ่บ้านพรทิพา 4,ชุมชนเมือง,200,89,111
1023,หนองแขม,หนองแขม,หมู่ 4 วัดศรีนวล,ชุมชนชานเมือง,481,233,248
1023,หนองแขม,หนองแขม,แย้มผกาสามัคคี หมู่ 13,ชุมชนชานเมือง,507,248,259
1023,หนองแขม,หนองแขม,เพิ่มดีพัฒนา,ชุมชนชานเมือง,318,135,183
1023,หนองแขม,หนองแขม,ซอย 99,ชุมชนชานเมือง,258,140,118
1023,หนองแขม,หนองแขม,เปรมปรีดิ์,ชุมชนเมือง,409,193,216
1023,หนองแขม,หนองแขม,หมู่บ้านอรุณทอง 2,ชุมชนเมือง,1469,652,817
1023,หนองแขม,หนองค้างพลู,ซอยต้นสน,ชุมชนชานเมือง,459,217,242
1023,หนองแขม,หนองค้างพลู,ฉัตรชัยเสริมโชค,ชุมชนชานเมือง,1858,898,960
1023,หนองแขม,หนองค้างพลู,ซอยกำนันวิจิตร,ชุมชนชานเมือง,1371,667,704
1023,หนองแขม,หนองค้างพลู,ซอยนาคสถาพร 1,ชุมชนชานเมือง,1039,464,575
1023,หนองแขม,หนองค้างพลู,ซอยนาคสถาพร 2,ชุมชนชานเมือง,359,196,163
1023,หนองแขม,หนองค้างพลู,ซอยเพชรเกษม 108,ชุมชนชานเมือง,288,135,153
1023,หนองแขม,หนองค้างพลู,ซอยเพชรเกษม 112,ชุมชนชานเมือง,347,185,162
1023,หนองแขม,หนองค้างพลู,ซอยหล่อพระ,ชุมชนชานเมือง,268,97,171
1023,หนองแขม,หนองค้างพลู,รักเจริญ,ชุมชนชานเมือง,596,286,310
1023,หนองแขม,หนองค้างพลู,เลียบคลองมหาศร,ชุมชนชานเมือง,177,82,95
1023,หนองแขม,หนองค้างพลู,วัดวงษ์ลาภาราม,ชุมชนชานเมือง,851,449,402
1023,หนองแขม,หนองค้างพลู,หมู่ 3 หนองค้างพลู,ชุมชนชานเมือง,1180,625,555
1023,หนองแขม,หนองค้างพลู,หมู่ 4 หนองค้างพลู,ชุมชนชานเมือง,471,186,285
1023,หนองแขม,หนองค้างพลู,หมู่บ้านชมเดือน 2,ชุมชนเมือง,926,425,501
1023,หนองแขม,หนองค้างพลู,สงวนคำ,ชุมชนชานเมือง,733,345,388
1023,หนองแขม,หนองค้างพลู,ชายแดน,ชุมชนชานเมือง,613,314,299
1023,หนองแขม,หนองค้างพลู,แสงศิริ,ชุมชนชานเมือง,680,338,342
1023,หนองแขม,หนองค้างพลู,สามัคคี 4-6,ชุมชนชานเมือง,2060,960,1100
1023,หนองแขม,หนองค้างพลู,ซอยเพชรเกษม 116,ชุมชนชานเมือง,1413,636,777
1023,หนองแขม,หนองค้างพลู,ดวงเดือน,ชุมชนชานเมือง,398,138,260
1023,หนองแขม,หนองค้างพลู,หมู่บ้านหรรษา 3 โครงการวีว่า (ซอยสนอง),ชุมชนเมือง,768,383,385
1023,หนองแขม,หนองค้างพลู,ริมคลองราษฎร์เจริญสุข,ชุมชนชานเมือง,620,312,308
1023,หนองแขม,หนองค้างพลู,สร้อยมาลา,ชุมชนเมือง,890,430,460
1023,หนองแขม,หนองค้างพลู,จันทร์ทรัพย์,ชุมชนเมือง,610,297,313
1023,หนองแขม,หนองค้างพลู,ซอยสามัคคี,ชุมชนชานเมือง,362,153,209
1023,หนองแขม,หนองค้างพลู,หรรษากรมที่ดิน,ชุมชนเมือง,510,212,298
1023,หนองแขม,หนองค้างพลู,หรรษาชัยพัฒนา,ชุมชนเมือง,507,252,255
1023,หนองแขม,หนองค้างพลู,หรรษาร่วมใจ,ชุมชนเมือง,890,430,460
1023,หนองแขม,หนองค้างพลู,หรรษาสร้างสรรค์,ชุมชนเมือง,408,189,219
1023,หนองแขม,หนองค้างพลู,แยก 9 พัฒนา,ชุมชนชานเมือง,690,276,414
1023,หนองแขม,หนองค้างพลู,การค้าหนองแขม หมู่ 2,ชุมชนเมือง,1019,399,620
1023,หนองแขม,หนองค้างพลู,หลังตลาดศุนย์การค้าหนองแขม หมู่ 2,ชุมชนเมือง,399,212,187
1023,หนองแขม,หนองค้างพลู,คอนโดหนองแขม,ชุมชนอาคารสูง,816,402,414
1023,หนองแขม,หนองค้างพลู,บุญส่ง,ชุมชนแออัด,174,85,89
1023,หนองแขม,หนองค้างพลู,หรรษามาเจริญ,ชุมชนเมือง,614,301,313
1023,หนองแขม,หนองค้างพลู,จิตรณรงค์ 21,ชุมชนเมือง,1018,467,551
1023,หนองแขม,หนองค้างพลู,กองขยะหนองแขม,ชุมชนแออัด,650,314,336
1023,หนองแขม,หนองค้างพลู,ชายคลอง,ชุมชนชานเมือง,191,98,93
1023,หนองแขม,หนองค้างพลู,พงษ์ศิริชัย 2,ชุมชนเมือง,741,321,420
1023,หนองแขม,หนองค้างพลู,นาคสามัคคี,ชุมชนเมือง,502,167,335
1023,หนองแขม,หนองค้างพลู,หมู่บ้านสุขสันต์ 9,ชุมชนเมือง,667,301,366
1003,หนองจอก,กระทุ่มราย,แผ่นดินทองอัลฮาดีย์ หมู่ที่ 6,ชุมชนชานเมือง,650,320,330
1003,หนองจอก,กระทุ่มราย,แผ่นดินทองอินดารุลมีนา,ชุมชนชานเมือง,316,163,153
1003,หนองจอก,กระทุ่มราย,หมู่ 5,ชุมชนชานเมือง,460,200,260
1003,หนองจอก,กระทุ่มราย,แผ่นดินทองดารุ้ลฆอนี หมู่ที่ 10,ชุมชนชานเมือง,368,176,192
1003,หนองจอก,กระทุ่มราย,แผ่นดินทองนูรุ้ลยากีน,ชุมชนชานเมือง,768,371,397
1003,หนองจอก,กระทุ่มราย,แผ่นดินทองออมสินพัฒนา,ชุมชนชานเมือง,182,80,102
1003,หนองจอก,กระทุ่มราย,แผ่นดินทองบ้านกระทุ่มราย,ชุมชนชานเมือง,1204,585,619
1003,หนองจอก,กระทุ่มราย,หมู่บ้านเลียบวารี,ชุมชนชานเมือง,501,140,361
1003,หนองจอก,กระทุ่มราย,แผ่นดินทองเจริญดำริ,ชุมชนชานเมือง,415,200,215
1003,หนองจอก,กระทุ่มราย,ซอยศาสนา,ชุมชนชานเมือง,317,172,145
1003,หนองจอก,กระทุ่มราย,รุ่งเรือง,ชุมชนชานเมือง,652,317,335
1003,หนองจอก,กระทุ่มราย,เกาะกลางพัฒนา,ชุมชนชานเมือง,750,380,370
1003,หนองจอก,กระทุ่มราย,หมู่บ้านจามจุรี,ชุมชนเมือง,279,134,145
1003,หนองจอก,กระทุ่มราย,ป.เจริญมิตรพัฒนา,ชุมชนชานเมือง,653,271,382
1003,หนองจอก,กระทุ่มราย,ลำสลิดทองพัฒนา,ชุมชนชานเมือง,659,327,332
1003,หนองจอก,กระทุ่มราย,นันทวันเซ็นต์ 1,ชุมชนเมือง,1500,732,768
1003,หนองจอก,หนองจอก,แผ่นดินทองดารุสซุนนี,ชุมชนชานเมือง,480,216,264
1003,หนองจอก,หนองจอก,แผ่นดินทองอัรเราะห์มาน,ชุมชนชานเมือง,318,155,163
1003,หนองจอก,หนองจอก,แผ่นดินทองอัลฮุดา,ชุมชนชานเมือง,452,217,235
1003,หนองจอก,หนองจอก,แผ่นดินทองฮาซานุดดีน,ชุมชนชานเมือง,512,255,257
1003,หนองจอก,หนองจอก,มิตรไมตรีสัมพันธ์,ชุมชนชานเมือง,973,380,593
1003,หนองจอก,หนองจอก,เลียบคลองสิบสาม,ชุมชนชานเมือง,762,414,348
1003,หนองจอก,หนองจอก,กิติชัย 2,ชุมชนเมือง,534,272,262
1003,หนองจอก,หนองจอก,ผดุงพันธ์พัฒนา,ชุมชนชานเมือง,922,520,402
1003,หนองจอก,หนองจอก,แผ่นดินทองนูรุดดีน,ชุมชนชานเมือง,1024,460,564
1003,หนองจอก,หนองจอก,แผ่นดินทองบ้านเกาะพัฒนา,ชุมชนชานเมือง,790,413,377
1003,หนองจอก,หนองจอก,หมู่บ้านธันยพฤกษ์,ชุมชนเมือง,2352,1124,1228
1003,หนองจอก,หนองจอก,หมู่ที่ 8 หนองจอกกงลิบฮัวเคียว,ชุมชนชานเมือง,288,120,168
1003,หนองจอก,หนองจอก,หมู่ 4 ร่วมพัฒนา,ชุมชนชานเมือง,380,201,179
1003,หนองจอก,หนองจอก,บึงฝรั่งพัฒนา,ชุมชนชานเมือง,569,297,272
1003,หนองจอก,หนองจอก,อัลฮุสนา,ชุมชนชานเมือง,439,213,226
1003,หนองจอก,หนองจอก,บ้านบึงเตย,ชุมชนชานเมือง,567,281,286
1003,หนองจอก,คลองสิบ,แผ่นดินทองดารุ้ลฮาซ่านัย,ชุมชนชานเมือง,1096,485,611
1003,หนองจอก,คลองสิบ,แผ่นดินทองสะฟีรุสซาลาม,ชุมชนชานเมือง,501,252,249
1003,หนองจอก,คลองสิบ,แผ่นดินทองอัลฮิดายะห์,ชุมชนชานเมือง,866,427,439
1003,หนองจอก,คลองสิบ,หมู่บ้านพัฒนาหมู่ 12-13,ชุมชนชานเมือง,852,395,457
1003,หนองจอก,คลองสิบ,สหกรณ์ 93 คลองสิบ,ชุมชนชานเมือง,379,191,188
1003,หนองจอก,คลองสิบ,บ้านคลองเก้า,ชุมชนชานเมือง,518,243,275
1003,หนองจอก,คลองสิบ,อุมาร์ 2,ชุมชนชานเมือง,336,162,174
1003,หนองจอก,คลองสิบ,อัลฟาลาห์,ชุมชนชานเมือง,1389,754,635
1003,หนองจอก,คลองสิบ,หมู่ 4 พัฒนา,ชุมชนชานเมือง,285,125,160
1003,หนองจอก,คลองสิบสอง,แผ่นดินทองบิดาย่าตุ้ลฮิดายะห์ (สุเหร่าสิบสี่),ชุมชนชานเมือง,561,273,288
1003,หนองจอก,คลองสิบสอง,แผ่นดินทองวัดพระยาปลา,ชุมชนชานเมือง,1350,608,742
1003,หนองจอก,คลองสิบสอง,แผ่นดินทองวัดแสนเกษม,ชุมชนชานเมือง,780,400,380
1003,หนองจอก,คลองสิบสอง,กิติเหมกรณ์,ชุมชนชานเมือง,2947,1213,1734
1003,หนองจอก,คลองสิบสอง,ประชาสำราญ,ชุมชนเมือง,508,258,250
1003,หนองจอก,คลองสิบสอง,วัดใหม่เจริญราษฎร์,ชุมชนชานเมือง,452,232,220
1003,หนองจอก,คลองสิบสอง,หมู่ 6 ก้าวหน้า,ชุมชนชานเมือง,900,400,500
1003,หนองจอก,คลองสิบสอง,ก้าวไกลพัฒนา,ชุมชนชานเมือง,506,248,258
1003,หนองจอก,คลองสิบสอง,ก้าวใหม่พัฒนาบึงปรง,ชุมชนชานเมือง,540,297,243
1003,หนองจอก,คลองสิบสอง,บ้านคลองนาหมอน,ชุมชนชานเมือง,272,133,139
1003,หนองจอก,โคกแฝด,ส่งเสริมศิลธรรม,ชุมชนชานเมือง,927,478,449
1003,หนองจอก,โคกแฝด,แผ่นดินทองคอยรุตตั๊กวา,ชุมชนชานเมือง,975,501,474
1003,หนองจอก,โคกแฝด,แผ่นดินทองซอลีฮุ้ลมุสลีมีน (ลำต้นกล้วย),ชุมชนชานเมือง,865,437,428
1003,หนองจอก,โคกแฝด,แผ่นดินทองมัสยิดนูรุสลาม (กุโบว์โต๊ะเยาะห์),ชุมชนชานเมือง,817,410,407
1003,หนองจอก,โคกแฝด,แผ่นดินทองภักดีธรรม,ชุมชนชานเมือง,567,205,362
1003,หนองจอก,โคกแฝด,แผ่นดินทองยะมีอุ้ลมุตตะกีน (ลำหินใต้),ชุมชนชานเมือง,387,188,199
1003,หนองจอก,โคกแฝด,พัฒนาบ้านแบนใหญ่,ชุมชนชานเมือง,773,395,378
1003,หนองจอก,โคกแฝด,แผ่นดินทองดารุ้ลคอยรอต (เจียระดับ) หมู่ที่ 2,ชุมชนชานเมือง,776,348,428
1003,หนองจอก,โคกแฝด,แผ่นดินทองนูรุ้ลเอี๊ยะซาน (ลำตาจีน) หมู่ที่ 4,ชุมชนชานเมือง,817,392,425
1003,หนองจอก,โคกแฝด,แผ่นดินทองคอยรุดดีน หมู่ที่ 5-6,ชุมชนชานเมือง,532,245,287
1003,หนองจอก,โคกแฝด,แผ่นดินทองสุกกาทอง,ชุมชนชานเมือง,469,226,243
1003,หนองจอก,โคกแฝด,แผ่นดินทองอัล-ยามีอะห์ (ลำอีรั้ว) หมู่ 7,ชุมชนชานเมือง,865,400,465
1003,หนองจอก,โคกแฝด,พัฒนาลำต้นไทร,ชุมชนชานเมือง,365,163,202
1003,หนองจอก,โคกแฝด,ร่วมพัฒนาสินอนันต์,ชุมชนเมือง,1070,543,527
1003,หนองจอก,โคกแฝด,นาตับสร้างสรรค์,ชุมชนชานเมือง,641,321,320
1003,หนองจอก,โคกแฝด,แผ่นดินทองดารุสสลาม (บาหยัน 1),ชุมชนชานเมือง,598,289,309
1003,หนองจอก,โคกแฝด,หมู่บ้านอมรทรัพย์,ชุมชนเมือง,1603,765,838
1003,หนองจอก,โคกแฝด,บ้านทรัพย์เจริญ,ชุมชนเมือง,1696,830,866
1003,หนองจอก,โคกแฝด,ดำรงสันติธรรม,ชุมชนชานเมือง,834,397,437
1003,หนองจอก,โคกแฝด,หมู่บ้านพิบูลทรัพย์ 17,ชุมชนเมือง,1038,475,563
1003,หนองจอก,โคกแฝด,หมู่บ้านพิบูลทรัพย์ 1,ชุมชนเมือง,883,423,460
1003,หนองจอก,คู้ฝั่งเหนือ,แผ่นดินทองวัดสามง่าม,ชุมชนชานเมือง,793,392,401
1003,หนองจอก,คู้ฝั่งเหนือ,ยายชุ่มอุทิศ,ชุมชนชานเมือง,165,78,87
1003,หนองจอก,คู้ฝั่งเหนือ,หมู่ 2,ชุมชนชานเมือง,511,269,242
1003,หนองจอก,คู้ฝั่งเหนือ,แผ่นดินทองดารุ้ลนาอีม (แบนชะโด) หมู่ที่ 4,ชุมชนชานเมือง,423,203,220
1003,หนองจอก,คู้ฝั่งเหนือ,แผ่นดินทองบาหยัน 2 หมู่ที่ 1,ชุมชนชานเมือง,625,294,331
1003,หนองจอก,คู้ฝั่งเหนือ,แผ่นดินทองคู้บนพัฒนา,ชุมชนชานเมือง,373,184,189
1003,หนองจอก,คู้ฝั่งเหนือ,พัฒนาศาลาร่วมใจ,ชุมชนชานเมือง,1096,533,563
1003,หนองจอก,คู้ฝั่งเหนือ,หมู่บ้านกิตติชัยวิลล่า 3,ชุมชนเมือง,1436,718,718
1003,หนองจอก,คู้ฝั่งเหนือ,เคหะหนองจอก,ชุมชนเมือง,889,433,456
1003,หนองจอก,ลำผักชี,แผ่นดินทองดารุ้ลนาซีฮะห์,ชุมชนชานเมือง,1374,684,690
1003,หนองจอก,ลำผักชี,แผ่นดินทองวัดลำผักชี หมู่ที่ 6,ชุมชนชานเมือง,411,204,207
1003,หนองจอก,ลำผักชี,แผ่นดินทองวัดลำพะอง หมู่ที่ 7,ชุมชนชานเมือง,1250,556,694
1003,หนองจอก,ลำผักชี,แผ่นดินทองลำมดตะนอยสร้างสรรค์,ชุมชนชานเมือง,1690,847,843
1003,หนองจอก,ลำผักชี,แผ่นดินทองศิริวังพัฒนา,ชุมชนชานเมือง,740,364,376
1003,หนองจอก,ลำผักชี,สุขใจวิลเลจ 2,ชุมชนเมือง,301,144,157
1003,หนองจอก,ลำผักชี,หมู่บ้านพิบูลย์ทรัพย์ 15,ชุมชนเมือง,846,397,449
1003,หนองจอก,ลำผักชี,เคหะชุมชนฉลองกรุงโซน 6,ชุมชนเมือง,1300,584,716
1003,หนองจอก,ลำผักชี,ลำผักชีก้าวหน้า,ชุมชนชานเมือง,553,262,291
1003,หนองจอก,ลำผักชี,เคหะชุมชนฉลองกรุงโซน 4,ชุมชนเมือง,1349,654,695
1003,หนองจอก,ลำต้อยติ่ง,แผ่นดินทองดารุ้ลอะมาน,ชุมชนชานเมือง,1036,522,514
1003,หนองจอก,ลำต้อยติ่ง,แผ่นดินทองนูรุ้ลลอฮ์ (ลำโขล่),ชุมชนชานเมือง,1028,521,507
1003,หนองจอก,ลำต้อยติ่ง,แผ่นดินทองวัดราษฎร์บำรุง,ชุมชนชานเมือง,1595,765,830
1003,หนองจอก,ลำต้อยติ่ง,แผ่นดินทองวัดลำต้อยติ่ง,ชุมชนชานเมือง,1023,504,519
1003,หนองจอก,ลำต้อยติ่ง,ลำตามีพัฒนา,ชุมชนชานเมือง,547,301,246
1003,หนองจอก,ลำต้อยติ่ง,วัดใหม่กระทุ่มล้ม,ชุมชนชานเมือง,964,470,494
1003,หนองจอก,ลำต้อยติ่ง,หมู่ 5 ลำต้อยติ่ง,ชุมชนชานเมือง,340,147,193
1003,หนองจอก,ลำต้อยติ่ง,เคหะฉลองกรุงโซน 5,ชุมชนเมือง,1216,578,638
1041,หลักสี่,ทุ่งสองห้อง,เคหะชุมชนท่าทราย,ชุมชนเมือง,8135,3882,4253
1041,หลักสี่,ทุ่งสองห้อง,ชวนชื่นบางเขน,ชุมชนเมือง,3242,1432,1810
1041,หลักสี่,ทุ่งสองห้อง,ชินเขต,ชุมชนเมือง,13537,6200,7337
1041,หลักสี่,ทุ่งสองห้อง,พงษ์เพชรแจ้งวัฒนะ 14,ชุมชนเมือง,1556,754,802
1041,หลักสี่,ทุ่งสองห้อง,ร่วมกิจกรุงศรีพัฒนา,ชุมชนเมือง,297,133,164
1041,หลักสี่,ทุ่งสองห้อง,แฟลตตำรวจส่วนกลาง ทุ่งสองห้อง,ชุมชนอาคารสูง,2000,1200,800
1041,หลักสี่,ทุ่งสองห้อง,ก้าวหน้า,ชุมชนแออัด,1729,835,894
1041,หลักสี่,ทุ่งสองห้อง,คลองเปรมประชาพัฒนา,ชุมชนแออัด,1109,514,595
1041,หลักสี่,ทุ่งสองห้อง,ศิษย์หลวงปู่ขาววัดหลักสี่,ชุมชนแออัด,1131,485,646
1041,หลักสี่,ทุ่งสองห้อง,เทวสุนทร,ชุมชนแออัด,537,243,294
1041,หลักสี่,ทุ่งสองห้อง,ร่วมพัฒนา,ชุมชนแออัด,1054,503,551
1041,หลักสี่,ทุ่งสองห้อง,แจ้งวัฒนะผาสุข หมู่ที่ 4,ชุมชนเมือง,4600,2100,2500
1041,หลักสี่,ทุ่งสองห้อง,มิตรประชาพัฒนา,ชุมชนแออัด,450,200,250
1041,หลักสี่,ทุ่งสองห้อง,เคหะชุมชนทุ่งสองห้อง 318,ชุมชนเมือง,290,133,157
1041,หลักสี่,ทุ่งสองห้อง,เคหะชุมชนทุ่งสองห้อง 325,ชุมชนเมือง,150,65,85
1041,หลักสี่,ทุ่งสองห้อง,เคหะชุมชนทุ่งสองห้อง 301,ชุมชนเมือง,217,105,112
1041,หลักสี่,ทุ่งสองห้อง,เคหะชุมชนทุ่งสองห้อง 304,ชุมชนเมือง,159,74,85
1041,หลักสี่,ทุ่งสองห้อง,เคหะชุมชนทุ่งสองห้อง 305,ชุมชนเมือง,258,104,154
1041,หลักสี่,ทุ่งสองห้อง,เคหะชุมชนทุ่งสองห้อง 306,ชุมชนเมือง,605,282,323
1041,หลักสี่,ทุ่งสองห้อง,เคหะชุมชนทุ่งสองห้อง 307,ชุมชนเมือง,352,153,199
1041,หลักสี่,ทุ่งสองห้อง,เคหะชุมชนทุ่งสองห้อง 308,ชุมชนเมือง,341,145,196
1041,หลักสี่,ทุ่งสองห้อง,เคหะชุมชนทุ่งสองห้อง 311,ชุมชนเมือง,203,99,104
1041,หลักสี่,ทุ่งสองห้อง,เคหะชุมชนทุ่งสองห้อง 316,ชุมชนเมือง,325,147,178
1041,หลักสี่,ทุ่งสองห้อง,เคหะชุมชนทุ่งสองห้อง 317,ชุมชนเมือง,380,186,194
1041,หลักสี่,ทุ่งสองห้อง,เคหะชุมชนทุ่งสองห้อง 320,ชุมชนเมือง,500,220,280
1041,หลักสี่,ทุ่งสองห้อง,เคหะชุมชนทุ่งสองห้อง 322,ชุมชนเมือง,247,101,146
1041,หลักสี่,ทุ่งสองห้อง,เคหะชุมชนทุ่งสองห้อง 328,ชุมชนเมือง,243,100,143
1041,หลักสี่,ทุ่งสองห้อง,เคหะชุมชนทุ่งสองห้อง 309,ชุมชนเมือง,179,88,91
1041,หลักสี่,ทุ่งสองห้อง,เคหะชุมชนทุ่งสองห้อง 310,ชุมชนเมือง,417,175,242
1041,หลักสี่,ทุ่งสองห้อง,เคหะชุมชนทุ่งสองห้อง 313,ชุมชนเมือง,451,194,257
1041,หลักสี่,ทุ่งสองห้อง,เคหะชุมชนทุ่งสองห้อง 319,ชุมชนเมือง,251,116,135
1041,หลักสี่,ทุ่งสองห้อง,เคหะชุมชนทุ่งสองห้อง 321,ชุมชนเมือง,218,98,120
1041,หลักสี่,ทุ่งสองห้อง,เคหะชุมชนทุ่งสองห้อง 323,ชุมชนเมือง,190,91,99
1041,หลักสี่,ทุ่งสองห้อง,เคหะชุมชนทุ่งสองห้อง 327,ชุมชนเมือง,230,110,120
1041,หลักสี่,ทุ่งสองห้อง,เคหะชุมชนทุ่งสองห้อง 302,ชุมชนเมือง,341,160,181
1041,หลักสี่,ทุ่งสองห้อง,เคหะชุมชนทุ่งสองห้อง 303,ชุมชนเมือง,417,222,195
1041,หลักสี่,ทุ่งสองห้อง,เคหะชุมชนทุ่งสองห้อง 315,ชุมชนเมือง,365,176,189
1041,หลักสี่,ทุ่งสองห้อง,เคหะชุมชนทุ่งสองห้อง 324,ชุมชนเมือง,272,106,166
1041,หลักสี่,ทุ่งสองห้อง,เคหะชุมชนทุ่งสองห้อง 329,ชุมชนเมือง,250,118,132
1041,หลักสี่,ทุ่งสองห้อง,เคหะชุมชนทุ่งสองห้อง 330,ชุมชนเมือง,422,197,225
1041,หลักสี่,ทุ่งสองห้อง,เคหะชุมชนทุ่งสองห้อง 312,ชุมชนเมือง,641,334,307
1041,หลักสี่,ทุ่งสองห้อง,หมู่บ้านรัตนชัยวิลล่า,ชุมชนเมือง,511,241,270
1041,หลักสี่,ทุ่งสองห้อง,หมู่บ้านลออทิพย์,ชุมชนเมือง,588,290,298
1041,หลักสี่,ทุ่งสองห้อง,หมู่บ้าน กฟภ.นิเวศน์ 2,ชุมชนเมือง,800,340,460
1041,หลักสี่,ทุ่งสองห้อง,กองทหารพลาธิการ กองพลที่ 1 รักษาพระองค์,ชุมชนอาคารสูง,202,155,47
1041,หลักสี่,ทุ่งสองห้อง,กองสรรพาวุธเบา พล.1 รอ.,ชุมชนอาคารสูง,535,315,220
1041,หลักสี่,ทุ่งสองห้อง,ไทรงาม,ชุมชนแออัด,220,111,109
1041,หลักสี่,ทุ่งสองห้อง,ปตอ. 1 (1),ชุมชนอาคารสูง,909,534,375
1041,หลักสี่,ทุ่งสองห้อง,ปตอ. 1 (2),ชุมชนอาคารสูง,1206,531,675
1041,หลักสี่,ทุ่งสองห้อง,พงษ์เพชรพัฒนา,ชุมชนเมือง,720,180,540
1041,หลักสี่,ทุ่งสองห้อง,คนรักถิ่น,ชุมชนแออัด,480,239,241
1041,หลักสี่,ทุ่งสองห้อง,ทหารเสือ,ชุมชนอาคารสูง,1141,720,421
1041,หลักสี่,ทุ่งสองห้อง,อยู่แล้วรวย,ชุมชนเมือง,588,252,336
1041,หลักสี่,ทุ่งสองห้อง,ชาวลาดตระเวน,ชุมชนอาคารสูง,350,212,138
1041,หลักสี่,ทุ่งสองห้อง,แฟลตตำรวจอิสระ,ชุมชนอาคารสูง,214,124,90
1041,หลักสี่,ทุ่งสองห้อง,หลักสี่,ชุมชนอาคารสูง,271,121,150
1041,หลักสี่,ทุ่งสองห้อง,หมู่บ้านราชพฤกษ์,ชุมชนเมือง,432,188,244
1041,หลักสี่,ทุ่งสองห้อง,หมู่บ้านชื่นกมลนิเวศน์ 1,ชุมชนเมือง,257,109,148
1041,หลักสี่,ทุ่งสองห้อง,ร่มเย็นพัฒนา,ชุมชนเมือง,215,103,112
1041,หลักสี่,ทุ่งสองห้อง,ยิ้มสยาม,ชุมชนเมือง,259,157,102
1041,หลักสี่,ทุ่งสองห้อง,มีสุข,ชุมชนเมือง,647,266,381
1041,หลักสี่,ทุ่งสองห้อง,หมู่บ้านพงษ์เพชรวิลล่า,ชุมชนเมือง,179,79,100
1041,หลักสี่,ทุ่งสองห้อง,พินิจสินละออ,ชุมชนชานเมือง,495,235,260
1041,หลักสี่,ตลาดบางเขน,เคหะชุมชนบางบัว,ชุมชนเมือง,1653,750,903
1041,หลักสี่,ตลาดบางเขน,บางบัวหมู่บ้านอาทิตย์,ชุมชนเมือง,643,312,331
1041,หลักสี่,ตลาดบางเขน,ชายคลองบางบัว,ชุมชนแออัด,1985,1045,940
1041,หลักสี่,ตลาดบางเขน,หลังแฟลตร่วมพัฒนา,ชุมชนแออัด,695,262,433
1041,หลักสี่,ตลาดบางเขน,ตรีเพชร 2,ชุมชนอาคารสูง,510,215,295
1041,หลักสี่,ตลาดบางเขน,เปรมสุขสันต์,ชุมชนแออัด,804,363,441
1041,หลักสี่,ตลาดบางเขน,อยู่ดีมีสุขร่วมใจ,ชุมชนแออัด,1008,408,600
1041,หลักสี่,ตลาดบางเขน,ตลาดหลักสี่,ชุมชนแออัด,648,308,340
1041,หลักสี่,ตลาดบางเขน,บางบัวเชิงสะพานไม้ 1,ชุมชนเมือง,278,134,144
1041,หลักสี่,ตลาดบางเขน,บางบัวร่วมใจพัฒนา (เชิงสะพานไม้ 2),ชุมชนแออัด,730,344,386
1041,หลักสี่,ตลาดบางเขน,หลักสี่พัฒนา 99,ชุมชนแออัด,367,172,195
1041,หลักสี่,ตลาดบางเขน,ซอยพัชราภา,ชุมชนเมือง,1284,622,662
1041,หลักสี่,ตลาดบางเขน,หมู่บ้านมหานครนิเวศน์,ชุมชนเมือง,871,386,485
1017,ห้วยขวาง,ห้วยขวาง,หมู่บ้านซอยสุนทรศิริ,ชุมชนเมือง,950,423,527
1017,ห้วยขวาง,ห้วยขวาง,ซอยประชาราษฎร์บำเพ็ญ 12,ชุมชนเมือง,380,189,191
1017,ห้วยขวาง,บางกะปิ,บึงพระราม 9,ชุมชนแออัด,850,428,422
1017,ห้วยขวาง,บางกะปิ,บึงพระราม 9 พัฒนา,ชุมชนแออัด,910,405,505
1017,ห้วยขวาง,บางกะปิ,หมู่บ้านศรีนคร,ชุมชนเมือง,150,69,81
1017,ห้วยขวาง,บางกะปิ,หลังสมาคมโรงเรียนไทย-ญี่ปุ่น,ชุมชนแออัด,396,181,215
1017,ห้วยขวาง,บางกะปิ,เพชรพระราม,ชุมชนแออัด,1010,465,545
1017,ห้วยขวาง,บางกะปิ,โรงปูนฝั่งใต้,ชุมชนแออัด,946,402,544
1017,ห้วยขวาง,บางกะปิ,โรงปูนฝั่งเหนือ,ชุมชนแออัด,1000,450,550
1017,ห้วยขวาง,บางกะปิ,เพชรบุรี 40,ชุมชนแออัด,374,192,182
1017,ห้วยขวาง,บางกะปิ,แฟลตสถานีตำรวจนครบาลมักกะสัน,ชุมชนอาคารสูง,239,128,111
1017,ห้วยขวาง,บางกะปิ,ทับแก้ว,ชุมชนแออัด,650,299,351
1017,ห้วยขวาง,สามเสนนอก,รุ่งเรืองตอนปลาย,ชุมชนแออัด,700,350,350
1017,ห้วยขวาง,สามเสนนอก,ร่วมใจพิบูล 2,ชุมชนแออัด,1300,652,648
1017,ห้วยขวาง,สามเสนนอก,ริมคลองบางซื่อลาดพร้าว 34,ชุมชนแออัด,713,325,388
1017,ห้วยขวาง,สามเสนนอก,ริมคลองบางซื่อลาดพร้าว 42-44,ชุมชนแออัด,930,411,519
1017,ห้วยขวาง,สามเสนนอก,ริมคลองบางซื่อลาดพร้าว 46,ชุมชนแออัด,255,170,85
1017,ห้วยขวาง,สามเสนนอก,ริมคลองลาดพร้าวประชาอุทิศ,ชุมชนแออัด,450,200,250
1017,ห้วยขวาง,สามเสนนอก,ลาดพร้าว 45,ชุมชนแออัด,2500,1150,1350
1017,ห้วยขวาง,สามเสนนอก,ลาดพร้าว 80,ชุมชนแออัด,912,501,411
1017,ห้วยขวาง,สามเสนนอก,ซอยพัทลุง,ชุมชนแออัด,607,279,328
1017,ห้วยขวาง,สามเสนนอก,หมู่บ้านประสิทธิ์,ชุมชนเมือง,347,125,222
